AAAAAGAGCGT -> AAAAGAGCGTA
AAAAAGCCCCT -> AAAAGCCCCTT
AAAAATTTCGT -> AAAATTTCGTC
AAAACACAAGG -> AAACACAAGGG
AAAACTAGTCC -> AAACTAGTCCC
AAAAGAGCGTA -> AAAGAGCGTAT
AAAAGCCCCTG -> AAAGCCCCTGA
AAAAGCCCCTT -> AAAGCCCCTTA
AAAAGGCTTGT -> AAAGGCTTGTG
AAAATTTCGTC -> AAATTTCGTCG
AAACACAAGGG -> AACACAAGGGA
AAACAGACACA -> AACAGACACAA
AAACCTAATAA -> AACCTAATAAG
AAACGAAGGCC -> AACGAAGGCCG
AAACGCAATCG -> AACGCAATCGT
AAACTAGTCCC -> AACTAGTCCCC
AAACTCAGGAC -> AACTCAGGACC
AAACTCCATGG -> AACTCCATGGG
AAACTTCACCG -> AACTTCACCGC
AAAGAACGTGA -> AAGAACGTGAT
AAAGAGCGTAT -> AAGAGCGTATC
AAAGATGCTAC -> AAGATGCTACC
AAAGCCCCTGA -> AAGCCCCTGAC
AAAGCCCCTTA -> AAGCCCCTTAT
AAAGCTTCCCG -> AAGCTTCCCGA
AAAGCTTTGGC -> AAGCTTTGGCC
AAAGGAAGTTC -> AAGGAAGTTCC
AAAGGCTTGTG -> AAGGCTTGTGG
AAAGTGCATCT -> AAGTGCATCTA
AAATAGATCTT -> AATAGATCTTC
AAATGCATCAA -> AATGCATCAAA
AAATGCATGTC -> AATGCATGTCC
AAATTGTTGAG -> AATTGTTGAGC
AAATTTACCAT -> AATTTACCATC
AAATTTCGTCG -> AATTTCGTCGA
AACAACCTAAA -> ACAACCTAAAG
AACAATATATC -> ACAATATATCA
AACACAAGGGA -> ACACAAGGGAA
AACACGGATCA -> ACACGGATCAG
AACACTATGAA -> ACACTATGAAA
AACAGACACAA -> ACAGACACAAC
AACCACTTAAG -> ACCACTTAAGT
AACCATCACTT -> ACCATCACTTT
AACCCACTTGT -> ACCCACTTGTT
AACCGAGTCCG -> ACCGAGTCCGC
AACCTAAAGCT -> ACCTAAAGCTT
AACCTAATAAG -> ACCTAATAAGC
AACCTTTCTAA -> ACCTTTCTAAT
AACGAAGGCCG -> ACGAAGGCCGC
AACGAGCCCTG -> ACGAGCCCTGG
AACGCAATCGT -> ACGCAATCGTA
AACGCCGGTAT -> ACGCCGGTATT
AACGCGCCATT -> ACGCGCCATTA
AACGGAGCAGA -> ACGGAGCAGAT
AACGGATGTCA -> ACGGATGTCAC
AACGGGCGTGG -> ACGGGCGTGGG
AACGGGTCAAT -> ACGGGTCAATC
AACGTGATACA -> ACGTGATACAG
AACGTGGGTCC -> ACGTGGGTCCG
AACTAGGCATA -> ACTAGGCATAA
AACTAGTCCCC -> ACTAGTCCCCC
AACTATAAACT -> ACTATAAACTT
AACTCAGGACC -> ACTCAGGACCA
AACTCCATGGG -> ACTCCATGGGG
AACTCGATGAA -> ACTCGATGAAC
AACTTCACCGC -> ACTTCACCGCA
AACTTGGCGTA -> ACTTGGCGTAG
AAGAACCATCA -> AGAACCATCAC
AAGAACGTGAT -> AGAACGTGATA
AAGAACTATAA -> AGAACTATAAA
AAGAATTCCTC -> AGAATTCCTCC
AAGACCAGTTA -> AGACCAGTTAA
AAGAGCGTAGA -> AGAGCGTAGAC
AAGAGCGTATC -> AGAGCGTATCG
AAGATGCTACC -> AGATGCTACCA
AAGCACTAGTG -> AGCACTAGTGG
AAGCACTCGCT -> AGCACTCGCTC
AAGCCAAAGCT -> AGCCAAAGCTT
AAGCCAGAACG -> AGCCAGAACGA
AAGCCCCTGAC -> AGCCCCTGACG
AAGCCCCTTAT -> AGCCCCTTATC
AAGCTACCGGT -> AGCTACCGGTT
AAGCTTCCCGA -> AGCTTCCCGAC
AAGCTTTGGCC -> AGCTTTGGCCC
AAGGAAGTTCC -> AGGAAGTTCCG
AAGGACCTTTT -> AGGACCTTTTG
AAGGAGCGAGA -> AGGAGCGAGAC
AAGGAGTAGCG -> AGGAGTAGCGG
AAGGCCGCGAA -> AGGCCGCGAAG
AAGGCTTGTGG -> AGGCTTGTGGT
AAGGGAAGAAC -> AGGGAAGAACC
AAGGTAGGCAT -> AGGTAGGCATA
AAGTAACTAGG -> AGTAACTAGGC
AAGTAGCAAAA -> AGTAGCAAAAA
AAGTATGCTTG -> AGTATGCTTGA
AAGTCAATGAC -> AGTCAATGACA
AAGTCTGAGAC -> AGTCTGAGACG
AAGTGCATCTA -> AGTGCATCTAG
AAGTTCCCCCT -> AGTTCCCCCTG
AAGTTCCGGAA -> AGTTCCGGAAA
AATAACCTTTC -> ATAACCTTTCT
AATAAGCACTC -> ATAAGCACTCG
AATAAGGACCT -> ATAAGGACCTT
AATACACAAGC -> ATACACAAGCC
AATAGAGGCTT -> ATAGAGGCTTA
AATAGATCTTC -> ATAGATCTTCC
AATATAGCCTG -> ATATAGCCTGA
AATATAGTGAC -> ATATAGTGACG
AATATATCAGA -> ATATATCAGAA
AATCGGTTGTT -> ATCGGTTGTTC
AATCGTAAGGA -> ATCGTAAGGAG
AATCGTATCCG -> ATCGTATCCGT
AATCTGCTTAA -> ATCTGCTTAAA
AATCTTCACGC -> ATCTTCACGCC
AATGACACCCC -> ATGACACCCCC
AATGATGGCTA -> ATGATGGCTAC
AATGCATCAAA -> ATGCATCAAAA
AATGCATGTCC -> ATGCATGTCCC
AATGCTTCGTG -> ATGCTTCGTGG
AATGGGAATTC -> ATGGGAATTCT
AATTATTTACT -> ATTATTTACTT
AATTCCCATGG -> ATTCCCATGGG
AATTCCTCCGA -> ATTCCTCCGAA
AATTCTAGTCG -> ATTCTAGTCGC
AATTCTGTCAG -> ATTCTGTCAGT
AATTGTGTCGG -> ATTGTGTCGGG
AATTGTTGAGC -> ATTGTTGAGCC
AATTTACCATC -> ATTTACCATCA
AATTTCGTCGA -> ATTTCGTCGAA
AATTTTGCGCT -> ATTTTGCGCTG
ACAACACGGAT -> CAACACGGATC
ACAACACTATG -> CAACACTATGA
ACAACCTAAAG -> CAACCTAAAGC
ACAACGCCGGT -> CAACGCCGGTA
ACAACTTGGCG -> CAACTTGGCGT
ACAAGCCAGAA -> CAAGCCAGAAC
ACAAGGGAAGA -> CAAGGGAAGAA
ACAATAAGGAC -> CAATAAGGACC
ACAATATATCA -> CAATATATCAG
ACACAACACTA -> CACAACACTAT
ACACAAGCCAG -> CACAAGCCAGA
ACACAAGGGAA -> CACAAGGGAAG
ACACAGGCACC -> CACAGGCACCA
ACACCAGCTGT -> CACCAGCTGTT
ACACCCCCACC -> CACCCCCACCA
ACACGCGTCGT -> CACGCGTCGTA
ACACGGATCAG -> CACGGATCAGG
ACACGGGATCG -> CACGGGATCGA
ACACGGTATTT -> CACGGTATTTC
ACACGTGAACT -> CACGTGAACTC
ACACTAAACCT -> CACTAAACCTA
ACACTATGAAA -> CACTATGAAAG
ACACTTAAAAA -> CACTTAAAAAG
ACAGACACAAC -> CAGACACAACA
ACAGCAGTCGG -> CAGCAGTCGGA
ACAGGCACCAC -> CAGGCACCACA
ACAGGCACCAG -> CAGGCACCAGG
ACAGGCCGTTC -> CAGGCCGTTCC
ACAGTTGACGG -> CAGTTGACGGA
ACATACTCCCC -> CATACTCCCCT
ACATCTCGATA -> CATCTCGATAC
ACCAACGGATG -> CCAACGGATGT
ACCACACGGGA -> CCACACGGGAT
ACCACACGGTA -> CCACACGGTAT
ACCACAGCAGT -> CCACAGCAGTC
ACCACTTAAGT -> CCACTTAAGTA
ACCAGACGGTC -> CCAGACGGTCA
ACCAGCGAGCA -> CCAGCGAGCAG
ACCAGCTGTTT -> CCAGCTGTTTG
ACCAGGTAATA -> CCAGGTAATAT
ACCAGGTTCAC -> CCAGGTTCACT
ACCAGTTAAAA -> CCAGTTAAAAG
ACCATCAAGGT -> CCATCAAGGTA
ACCATCACTTT -> CCATCACTTTA
ACCCACTTGTT -> CCCACTTGTTC
ACCCATGTTAC -> CCCATGTTACG
ACCCCAAGTTC -> CCCCAAGTTCC
ACCCCACACGC -> CCCCACACGCG
ACCCCCACCAC -> CCCCCACCACA
ACCCGCGCAGG -> CCCGCGCAGGA
ACCCTACTGTG -> CCCTACTGTGC
ACCCTGAATAG -> CCCTGAATAGA
ACCGAGGTTGG -> CCGAGGTTGGA
ACCGAGTCCGC -> CCGAGTCCGCA
ACCGCATGGGG -> CCGCATGGGGT
ACCGGTTTGCA -> CCGGTTTGCAG
ACCGTTTATCA -> CCGTTTATCAG
ACCTAAAGCTT -> CCTAAAGCTTT
ACCTAATAAGC -> CCTAATAAGCA
ACCTCAGCCGT -> CCTCAGCCGTG
ACCTCCGTGGC -> CCTCCGTGGCA
ACCTCTGCCTG -> CCTCTGCCTGT
ACCTTTCTAAT -> CCTTTCTAATA
ACCTTTTGCCC -> CCTTTTGCCCC
ACGAAACTCCA -> CGAAACTCCAT
ACGAAATTGTT -> CGAAATTGTTG
ACGAAGCACTA -> CGAAGCACTAG
ACGAAGGCCGC -> CGAAGGCCGCG
ACGACGTCCTA -> CGACGTCCTAC
ACGAGCCCTGG -> CGAGCCCTGGA
ACGAGGGAAGC -> CGAGGGAAGCC
ACGAGGTGATT -> CGAGGTGATTG
ACGCAATCGTA -> CGCAATCGTAT
ACGCACCTCTG -> CGCACCTCTGC
ACGCACGGCAG -> CGCACGGCAGT
ACGCCAAGCTA -> CGCCAAGCTAC
ACGCCCTGGTT -> CGCCCTGGTTG
ACGCCGAGCGT -> CGCCGAGCGTG
ACGCCGGTATT -> CGCCGGTATTC
ACGCGCCATTA -> CGCGCCATTAC
ACGCGTCGTAT -> CGCGTCGTATC
ACGCTCGATGA -> CGCTCGATGAG
ACGCTCTCGCC -> CGCTCTCGCCG
ACGGAGCAGAT -> CGGAGCAGATC
ACGGAGGGCGT -> CGGAGGGCGTA
ACGGATCAGGA -> CGGATCAGGAG
ACGGATGTCAC -> CGGATGTCACG
ACGGCAGTATC -> CGGCAGTATCC
ACGGGATCGAT -> CGGGATCGATT
ACGGGCGTGGG -> CGGGCGTGGGA
ACGGGTCAATC -> CGGGTCAATCT
ACGGTATTTCT -> CGGTATTTCTG
ACGGTCAGTAA -> CGGTCAGTAAT
ACGTAAGTCAA -> CGTAAGTCAAT
ACGTCCCGCAA -> CGTCCCGCAAC
ACGTCCTACAC -> CGTCCTACACT
ACGTGAACTCG -> CGTGAACTCGA
ACGTGATACAG -> CGTGATACAGG
ACGTGGGTCCG -> CGTGGGTCCGA
ACGTTCCCGTG -> CGTTCCCGTGC
ACTAAACCTAA -> CTAAACCTAAT
ACTAGGCATAA -> CTAGGCATAAA
ACTAGTCCCCC -> CTAGTCCCCCG
ACTAGTGGTTG -> CTAGTGGTTGT
ACTATAAACTT -> CTATAAACTTC
ACTATGAAAGT -> CTATGAAAGTG
ACTCAGGACCA -> CTCAGGACCAG
ACTCCATGGGG -> CTCCATGGGGG
ACTCCCCTTCG -> CTCCCCTTCGT
ACTCGATGAAC -> CTCGATGAACC
ACTCGCTCTCA -> CTCGCTCTCAG
ACTCTTCTCTT -> CTCTTCTCTTT
ACTGACCCATG -> CTGACCCATGT
ACTGTGCTACT -> CTGTGCTACTG
ACTGTTGGCCG -> CTGTTGGCCGG
ACTTAAAAAGC -> CTTAAAAAGCC
ACTTAAGTATG -> CTTAAGTATGC
ACTTAGTCGAT -> CTTAGTCGATG
ACTTCACCGCA -> CTTCACCGCAT
ACTTGCGCGCC -> CTTGCGCGCCT
ACTTGGAACGG -> CTTGGAACGGG
ACTTGGCGTAG -> CTTGGCGTAGA
ACTTGTTCGTG -> CTTGTTCGTGC
ACTTTAGTCGG -> CTTTAGTCGGC
AGAACCATCAC -> GAACCATCACT
AGAACCGAGTC -> GAACCGAGTCC
AGAACGAGCCC -> GAACGAGCCCT
AGAACGGGTCA -> GAACGGGTCAA
AGAACGTGATA -> GAACGTGATAC
AGAACTATAAA -> GAACTATAAAC
AGAAGAACTAT -> GAAGAACTATA
AGAATCGGTTG -> GAATCGGTTGT
AGAATTCCTCC -> GAATTCCTCCG
AGACACAACAC -> GACACAACACT
AGACCAGTTAA -> GACCAGTTAAA
AGACCTCAGCC -> GACCTCAGCCG
AGACCTCCGTG -> GACCTCCGTGG
AGACGAAGCAC -> GACGAAGCACT
AGACGAGGTGA -> GACGAGGTGAT
AGACGGTCAGT -> GACGGTCAGTA
AGACTTGCGCG -> GACTTGCGCGC
AGAGAATCGGT -> GAGAATCGGTT
AGAGCGTAGAC -> GAGCGTAGACT
AGAGCGTATCG -> GAGCGTATCGG
AGAGGCTTAAC -> GAGGCTTAACG
AGAGTCCGCCA -> GAGTCCGCCAA
AGAGTGCACAA -> GAGTGCACAAC
AGATATGATAG -> GATATGATAGA
AGATCACGCAC -> GATCACGCACG
AGATCCAAAAC -> GATCCAAAACA
AGATCCTGTGG -> GATCCTGTGGA
AGATCTTCCGT -> GATCTTCCGTG
AGATGCTACCA -> GATGCTACCAG
AGCAAAAATTT -> GCAAAAATTTC
AGCACACAGGC -> GCACACAGGCA
AGCACTAGTGG -> GCACTAGTGGT
AGCACTCGCTC -> GCACTCGCTCT
AGCAGATCCTG -> GCAGATCCTGT
AGCAGCGTAGG -> GCAGCGTAGGC
AGCAGTCGGAA -> GCAGTCGGAAT
AGCCAAAGCTT -> GCCAAAGCTTC
AGCCAGAACGA -> GCCAGAACGAG
AGCCCCTGACG -> GCCCCTGACGC
AGCCCCTTATC -> GCCCCTTATCT
AGCCCTGGACG -> GCCCTGGACGC
AGCCGTGTACC -> GCCGTGTACCC
AGCCTAAGAAT -> GCCTAAGAATT
AGCCTGACCAA -> GCCTGACCAAC
AGCGAGACGAG -> GCGAGACGAGG
AGCGAGCAGCG -> GCGAGCAGCGT
AGCGATAATGA -> GCGATAATGAT
AGCGCCGGTAG -> GCGCCGGTAGG
AGCGCCTCTGA -> GCGCCTCTGAG
AGCGGCGCTTT -> GCGGCGCTTTC
AGCGGCTCTGT -> GCGGCTCTGTG
AGCGTAGACTT -> GCGTAGACTTG
AGCGTAGGCGG -> GCGTAGGCGGT
AGCGTATCGGT -> GCGTATCGGTA
AGCGTATTGCA -> GCGTATTGCAT
AGCGTGAAGAG -> GCGTGAAGAGC
AGCTACCGGTT -> GCTACCGGTTT
AGCTGTTTGAG -> GCTGTTTGAGA
AGCTTCCCGAC -> GCTTCCCGACC
AGCTTTGGCCC -> GCTTTGGCCCC
AGGAAGTTCCG -> GGAAGTTCCGG
AGGACCAGCGA -> GGACCAGCGAG
AGGACCCTACT -> GGACCCTACTG
AGGACCTTTTG -> GGACCTTTTGC
AGGAGCACACA -> GGAGCACACAG
AGGAGCGAGAC -> GGAGCGAGACG
AGGAGGCGCCA -> GGAGGCGCCAG
AGGAGGTGATC -> GGAGGTGATCA
AGGAGTAGCGG -> GGAGTAGCGGC
AGGCACCACAC -> GGCACCACACG
AGGCACCAGGT -> GGCACCAGGTA
AGGCATAAATG -> GGCATAAATGC
AGGCATACTCT -> GGCATACTCTT
AGGCCGCGAAG -> GGCCGCGAAGA
AGGCCGTTCCA -> GGCCGTTCCAG
AGGCGCCAGAG -> GGCGCCAGAGT
AGGCGGTCCGC -> GGCGGTCCGCT
AGGCTTAACGT -> GGCTTAACGTG
AGGCTTGTGGT -> GGCTTGTGGTA
AGGGAAGAACC -> GGGAAGAACCA
AGGGAAGCCAA -> GGGAAGCCAAA
AGGGCCGCGTA -> GGGCCGCGTAT
AGGGCGTATAG -> GGGCGTATAGA
AGGGTATAGGG -> GGGTATAGGGC
AGGTAATATAG -> GGTAATATAGC
AGGTAGGCATA -> GGTAGGCATAC
AGGTCTTCGCA -> GGTCTTCGCAT
AGGTGAACAAT -> GGTGAACAATA
AGGTGATCAGT -> GGTGATCAGTG
AGGTGATTGTG -> GGTGATTGTGT
AGGTTCACTTA -> GGTTCACTTAG
AGGTTGGACCC -> GGTTGGACCCG
AGGTTGTTCCG -> GGTTGTTCCGA
AGTAACTAGGC -> GTAACTAGGCA
AGTAATGCTTC -> GTAATGCTTCG
AGTAGCAAAAA -> GTAGCAAAAAT
AGTAGCGGCTC -> GTAGCGGCTCT
AGTATCCGAGG -> GTATCCGAGGG
AGTATGCTTGA -> GTATGCTTGAA
AGTCAAACTCA -> GTCAAACTCAG
AGTCAATGACA -> GTCAATGACAC
AGTCACGTAAG -> GTCACGTAAGT
AGTCCCCCGGC -> GTCCCCCGGCA
AGTCCGCAAGG -> GTCCGCAAGGA
AGTCCGCCAAT -> GTCCGCCAATA
AGTCGATGGCC -> GTCGATGGCCA
AGTCGCAATCG -> GTCGCAATCGT
AGTCGGAATAA -> GTCGGAATAAC
AGTCGGCAAAG -> GTCGGCAAAGG
AGTCTGAGACG -> GTCTGAGACGA
AGTCTGTGGAC -> GTCTGTGGACG
AGTGACGAAAC -> GTGACGAAACT
AGTGATGTTCA -> GTGATGTTCAC
AGTGCACAACA -> GTGCACAACAC
AGTGCATCTAG -> GTGCATCTAGT
AGTGGGGGAAC -> GTGGGGGAACG
AGTGGTTGTTG -> GTGGTTGTTGC
AGTGTGAATTT -> GTGTGAATTTT
AGTTAAAAGGC -> GTTAAAAGGCT
AGTTCCCCCTG -> GTTCCCCCTGC
AGTTCCGGAAA -> GTTCCGGAAAT
AGTTGACGGAG -> GTTGACGGAGG
AGTTTATTCCC -> GTTTATTCCCT
AGTTTTCTAGG -> GTTTTCTAGGA
ATAAACTTCAC -> TAAACTTCACC
ATAAATGCATC -> TAAATGCATCA
ATAACAACCTA -> TAACAACCTAA
ATAACCTTTCT -> TAACCTTTCTA
ATAAGCACTCG -> TAAGCACTCGC
ATAAGGACCTT -> TAAGGACCTTT
ATAATGATGGC -> TAATGATGGCT
ATACACAAGCC -> TACACAAGCCA
ATACAGGCACC -> TACAGGCACCA
ATACGACGTCC -> TACGACGTCCT
ATACGCCAAGC -> TACGCCAAGCT
ATACTCCCCTT -> TACTCCCCTTC
ATACTCTTCTC -> TACTCTTCTCT
ATACTGACCCA -> TACTGACCCAT
ATAGAGGCTTA -> TAGAGGCTTAA
ATAGAGTGCAC -> TAGAGTGCACA
ATAGATATGAT -> TAGATATGATA
ATAGATCTTCC -> TAGATCTTCCG
ATAGCCTGACC -> TAGCCTGACCA
ATAGCGGCGCT -> TAGCGGCGCTT
ATAGGGCCGCG -> TAGGGCCGCGT
ATAGTGACGAA -> TAGTGACGAAA
ATATAGCCTGA -> TATAGCCTGAC
ATATAGTGACG -> TATAGTGACGA
ATATATCAGAA -> TATATCAGAAC
ATATCAGAACC -> TATCAGAACCG
ATATGATAGAG -> TATGATAGAGT
ATATGTTCCAG -> TATGTTCCAGA
ATATTATTAAG -> TATTATTAAGT
ATCAAAAAGAG -> TCAAAAAGAGC
ATCAAGGTAGG -> TCAAGGTAGGC
ATCACGCACGG -> TCACGCACGGC
ATCACTTTAGT -> TCACTTTAGTC
ATCAGAACCGA -> TCAGAACCGAG
ATCAGCGTATT -> TCAGCGTATTG
ATCAGGAGGTG -> TCAGGAGGTGA
ATCAGTGGGGG -> TCAGTGGGGGA
ATCCAAAACAC -> TCCAAAACACA
ATCCGAGGGTA -> TCCGAGGGTAT
ATCCGGCTCAG -> TCCGGCTCAGA
ATCCGTGGCAT -> TCCGTGGCATC
ATCCTCACCGA -> TCCTCACCGAG
ATCCTGTGGAG -> TCCTGTGGAGG
ATCGATATTAT -> TCGATATTATT
ATCGATTGATG -> TCGATTGATGG
ATCGGTACGTC -> TCGGTACGTCC
ATCGGTCCGAA -> TCGGTCCGAAT
ATCGGTTGTTC -> TCGGTTGTTCC
ATCGTAAGGAG -> TCGTAAGGAGC
ATCGTATCCGT -> TCGTATCCGTG
ATCGTGCGTAC -> TCGTGCGTACG
ATCTAGGTTGT -> TCTAGGTTGTT
ATCTAGTGTGA -> TCTAGTGTGAA
ATCTCGATACG -> TCTCGATACGA
ATCTCGTTTTT -> TCTCGTTTTTT
ATCTGCGGTTC -> TCTGCGGTTCG
ATCTGCTTAAA -> TCTGCTTAAAC
ATCTTCACGCC -> TCTTCACGCCC
ATCTTCCGTGA -> TCTTCCGTGAT
ATGAAAGTGCA -> TGAAAGTGCAT
ATGAACCCACT -> TGAACCCACTT
ATGACACCCCC -> TGACACCCCCA
ATGAGTCTGTG -> TGAGTCTGTGG
ATGATAGAGTG -> TGATAGAGTGC
ATGATGGCTAC -> TGATGGCTACC
ATGCATCAAAA -> TGCATCAAAAA
ATGCATGTCCC -> TGCATGTCCCC
ATGCTACCAGG -> TGCTACCAGGT
ATGCTTCGTGG -> TGCTTCGTGGG
ATGCTTGAAAT -> TGCTTGAAATG
ATGGCAATGGG -> TGGCAATGGGA
ATGGCACACCA -> TGGCACACCAG
ATGGCCATCTG -> TGGCCATCTGC
ATGGCTACCCC -> TGGCTACCCCA
ATGGCTTTATG -> TGGCTTTATGG
ATGGGAATTCT -> TGGGAATTCTA
ATGGGATACGC -> TGGGATACGCC
ATGGGGGCACA -> TGGGGGCACAG
ATGGGGTAGCG -> TGGGGTAGCGA
ATGGGGTGCTT -> TGGGGTGCTTC
ATGGTTTTCTC -> TGGTTTTCTCT
ATGTCACGAAA -> TGTCACGAAAT
ATGTCCCCTAT -> TGTCCCCTATC
ATGTTACGCTC -> TGTTACGCTCT
ATGTTCACCAC -> TGTTCACCACA
ATGTTCCAGAC -> TGTTCCAGACC
ATGTTGCTTGA -> TGTTGCTTGAT
ATTAAGTAGCA -> TTAAGTAGCAA
ATTACCCTGAA -> TTACCCTGAAT
ATTACGCTCGA -> TTACGCTCGAT
ATTATTAAGTA -> TTATTAAGTAG
ATTATTTACTT -> TTATTTACTTG
ATTCAATTCTG -> TTCAATTCTGT
ATTCCCAGTCA -> TTCCCAGTCAC
ATTCCCATGGG -> TTCCCATGGGG
ATTCCCTGTGA -> TTCCCTGTGAG
ATTCCTCCGAA -> TTCCTCCGAAG
ATTCTAGTCGC -> TTCTAGTCGCA
ATTCTGTCAGT -> TTCTGTCAGTT
ATTGAGTTTTC -> TTGAGTTTTCT
ATTGATGGCAA -> TTGATGGCAAT
ATTGCATGGCT -> TTGCATGGCTT
ATTGGTCCTAG -> TTGGTCCTAGA
ATTGTGTCGGG -> TTGTGTCGGGA
ATTGTGTGTGG -> TTGTGTGTGGC
ATTGTTGAGCC -> TTGTTGAGCCT
ATTTACCATCA -> TTTACCATCAA
ATTTACTTGGA -> TTTACTTGGAA
ATTTCGTCGAA -> TTTCGTCGAAA
ATTTCGTGGCT -> TTTCGTGGCTC
ATTTCTGGAGT -> TTTCTGGAGTG
ATTTTGCGCTG -> TTTTGCGCTGC
CAAAAAGAGCG -> AAAAAGAGCGT
CAAAAATTTCG -> AAAAATTTCGT
CAAAACACAAG -> AAAACACAAGG
CAAAAGCCCCT -> AAAAGCCCCTG
CAAACTCAGGA -> AAACTCAGGAC
CAAAGCTTCCC -> AAAGCTTCCCG
CAAAGGAAGTT -> AAAGGAAGTTC
CAAATAGATCT -> AAATAGATCTT
CAACACGGATC -> AACACGGATCA
CAACACTATGA -> AACACTATGAA
CAACCACTTAA -> AACCACTTAAG
CAACCTAAAGC -> AACCTAAAGCT
CAACGCCGGTA -> AACGCCGGTAT
CAACGGATGTC -> AACGGATGTCA
CAACTTGGCGT -> AACTTGGCGTA
CAAGCCAGAAC -> AAGCCAGAACG
CAAGCTACCGG -> AAGCTACCGGT
CAAGGAGTAGC -> AAGGAGTAGCG
CAAGGGAAGAA -> AAGGGAAGAAC
CAAGGTAGGCA -> AAGGTAGGCAT
CAAGTAACTAG -> AAGTAACTAGG
CAAGTTCCCCC -> AAGTTCCCCCT
CAATAAGGACC -> AATAAGGACCT
CAATATAGTGA -> AATATAGTGAC
CAATATATCAG -> AATATATCAGA
CAATCGTAAGG -> AATCGTAAGGA
CAATCGTATCC -> AATCGTATCCG
CAATCTTCACG -> AATCTTCACGC
CAATGACACCC -> AATGACACCCC
CAATGGGAATT -> AATGGGAATTC
CAATTATTTAC -> AATTATTTACT
CAATTCTGTCA -> AATTCTGTCAG
CACAACACGGA -> ACAACACGGAT
CACAACACTAT -> ACAACACTATG
CACAACGCCGG -> ACAACGCCGGT
CACAACTTGGC -> ACAACTTGGCG
CACAAGCCAGA -> ACAAGCCAGAA
CACAAGGGAAG -> ACAAGGGAAGA
CACAATAAGGA -> ACAATAAGGAC
CACACAGGCAC -> ACACAGGCACC
CACACCAGCTG -> ACACCAGCTGT
CACACGCGTCG -> ACACGCGTCGT
CACACGGGATC -> ACACGGGATCG
CACACGGTATT -> ACACGGTATTT
CACACTTAAAA -> ACACTTAAAAA
CACAGCAGTCG -> ACAGCAGTCGG
CACAGGCACCA -> ACAGGCACCAG
CACAGTTGACG -> ACAGTTGACGG
CACCACACGGG -> ACCACACGGGA
CACCACACGGT -> ACCACACGGTA
CACCACAGCAG -> ACCACAGCAGT
CACCAGCTGTT -> ACCAGCTGTTT
CACCAGGTAAT -> ACCAGGTAATA
CACCCCCACCA -> ACCCCCACCAC
CACCGAGGTTG -> ACCGAGGTTGG
CACCGCATGGG -> ACCGCATGGGG
CACCTCTGCCT -> ACCTCTGCCTG
CACGAAATTGT -> ACGAAATTGTT
CACGCACGGCA -> ACGCACGGCAG
CACGCCCTGGT -> ACGCCCTGGTT
CACGCGTCGTA -> ACGCGTCGTAT
CACGGATCAGG -> ACGGATCAGGA
CACGGCAGTAT -> ACGGCAGTATC
CACGGGATCGA -> ACGGGATCGAT
CACGGTATTTC -> ACGGTATTTCT
CACGTAAGTCA -> ACGTAAGTCAA
CACGTGAACTC -> ACGTGAACTCG
CACTAAACCTA -> ACTAAACCTAA
CACTAGTGGTT -> ACTAGTGGTTG
CACTATGAAAG -> ACTATGAAAGT
CACTCGCTCTC -> ACTCGCTCTCA
CACTTAAAAAG -> ACTTAAAAAGC
CACTTAAGTAT -> ACTTAAGTATG
CACTTAGTCGA -> ACTTAGTCGAT
CACTTGTTCGT -> ACTTGTTCGTG
CACTTTAGTCG -> ACTTTAGTCGG
CAGAACCGAGT -> AGAACCGAGTC
CAGAACGAGCC -> AGAACGAGCCC
CAGACACAACA -> AGACACAACAC
CAGACCTCAGC -> AGACCTCAGCC
CAGACGGTCAG -> AGACGGTCAGT
CAGAGTCCGCC -> AGAGTCCGCCA
CAGATCACGCA -> AGATCACGCAC
CAGATCCTGTG -> AGATCCTGTGG
CAGCAGTCGGA -> AGCAGTCGGAA
CAGCCGTGTAC -> AGCCGTGTACC
CAGCGAGCAGC -> AGCGAGCAGCG
CAGCGCCTCTG -> AGCGCCTCTGA
CAGCGTAGGCG -> AGCGTAGGCGG
CAGCGTATTGC -> AGCGTATTGCA
CAGCTGTTTGA -> AGCTGTTTGAG
CAGGACCAGCG -> AGGACCAGCGA
CAGGACCCTAC -> AGGACCCTACT
CAGGAGGTGAT -> AGGAGGTGATC
CAGGCACCACA -> AGGCACCACAC
CAGGCACCAGG -> AGGCACCAGGT
CAGGCCGTTCC -> AGGCCGTTCCA
CAGGTAATATA -> AGGTAATATAG
CAGGTCTTCGC -> AGGTCTTCGCA
CAGGTTCACTT -> AGGTTCACTTA
CAGTAATGCTT -> AGTAATGCTTC
CAGTATCCGAG -> AGTATCCGAGG
CAGTCAAACTC -> AGTCAAACTCA
CAGTCACGTAA -> AGTCACGTAAG
CAGTCGGAATA -> AGTCGGAATAA
CAGTGGGGGAA -> AGTGGGGGAAC
CAGTTAAAAGG -> AGTTAAAAGGC
CAGTTGACGGA -> AGTTGACGGAG
CAGTTTATTCC -> AGTTTATTCCC
CATAAATGCAT -> ATAAATGCATC
CATACTCCCCT -> ATACTCCCCTT
CATACTCTTCT -> ATACTCTTCTC
CATAGCGGCGC -> ATAGCGGCGCT
CATCAAAAAGA -> ATCAAAAAGAG
CATCAAGGTAG -> ATCAAGGTAGG
CATCACTTTAG -> ATCACTTTAGT
CATCCGGCTCA -> ATCCGGCTCAG
CATCGGTCCGA -> ATCGGTCCGAA
CATCGTGCGTA -> ATCGTGCGTAC
CATCTAGTGTG -> ATCTAGTGTGA
CATCTCGATAC -> ATCTCGATACG
CATCTGCGGTT -> ATCTGCGGTTC
CATGGCTTTAT -> ATGGCTTTATG
CATGGGGGCAC -> ATGGGGGCACA
CATGGGGTAGC -> ATGGGGTAGCG
CATGGGGTGCT -> ATGGGGTGCTT
CATGTCCCCTA -> ATGTCCCCTAT
CATGTTACGCT -> ATGTTACGCTC
CATTACCCTGA -> ATTACCCTGAA
CCAAAACACAA -> CAAAACACAAG
CCAAAGCTTCC -> CAAAGCTTCCC
CCAACGGATGT -> CAACGGATGTC
CCAAGCTACCG -> CAAGCTACCGG
CCAAGTTCCCC -> CAAGTTCCCCC
CCAATATAGTG -> CAATATAGTGA
CCAATTATTTA -> CAATTATTTAC
CCACACGCGTC -> CACACGCGTCG
CCACACGGGAT -> CACACGGGATC
CCACACGGTAT -> CACACGGTATT
CCACAGCAGTC -> CACAGCAGTCG
CCACCACACGG -> CACCACACGGG
CCACTTAAGTA -> CACTTAAGTAT
CCACTTGTTCG -> CACTTGTTCGT
CCAGAACGAGC -> CAGAACGAGCC
CCAGACCTCAG -> CAGACCTCAGC
CCAGACGGTCA -> CAGACGGTCAG
CCAGAGTCCGC -> CAGAGTCCGCC
CCAGCGAGCAG -> CAGCGAGCAGC
CCAGCGCCTCT -> CAGCGCCTCTG
CCAGCTGTTTG -> CAGCTGTTTGA
CCAGGTAATAT -> CAGGTAATATA
CCAGGTTCACT -> CAGGTTCACTT
CCAGTCACGTA -> CAGTCACGTAA
CCAGTTAAAAG -> CAGTTAAAAGG
CCATAGCGGCG -> CATAGCGGCGC
CCATCAAGGTA -> CATCAAGGTAG
CCATCACTTTA -> CATCACTTTAG
CCATCTGCGGT -> CATCTGCGGTT
CCATGGGGGCA -> CATGGGGGCAC
CCATGGGGTAG -> CATGGGGTAGC
CCATGTTACGC -> CATGTTACGCT
CCATTACCCTG -> CATTACCCTGA
CCCAAGTTCCC -> CCAAGTTCCCC
CCCAATTATTT -> CCAATTATTTA
CCCACACGCGT -> CCACACGCGTC
CCCACCACACG -> CCACCACACGG
CCCACTTGTTC -> CCACTTGTTCG
CCCAGTCACGT -> CCAGTCACGTA
CCCATAGCGGC -> CCATAGCGGCG
CCCATGGGGTA -> CCATGGGGTAG
CCCATGTTACG -> CCATGTTACGC
CCCCAAGTTCC -> CCCAAGTTCCC
CCCCACACGCG -> CCCACACGCGT
CCCCACCACAC -> CCCACCACACG
CCCCATAGCGG -> CCCATAGCGGC
CCCCCACCACA -> CCCCACCACAC
CCCCCATAGCG -> CCCCATAGCGG
CCCCCGGCACA -> CCCCGGCACAA
CCCCCTGCCGA -> CCCCTGCCGAA
CCCCGCACAAC -> CCCGCACAACG
CCCCGGCACAA -> CCCGGCACAAT
CCCCTATCTCG -> CCCTATCTCGT
CCCCTGACGCC -> CCCTGACGCCG
CCCCTGCCGAA -> CCCTGCCGAAC
CCCCTTATCTA -> CCCTTATCTAG
CCCCTTCGTTG -> CCCTTCGTTGT
CCCGACCGTTT -> CCGACCGTTTA
CCCGCAACCAC -> CCGCAACCACT
CCCGCACAACG -> CCGCACAACGC
CCCGCGCAGGA -> CCGCGCAGGAC
CCCGGCACAAT -> CCGGCACAATA
CCCGTGCTGTG -> CCGTGCTGTGA
CCCTACTGTGC -> CCTACTGTGCT
CCCTATCTCGT -> CCTATCTCGTT
CCCTGAATAGA -> CCTGAATAGAG
CCCTGACGCCG -> CCTGACGCCGA
CCCTGCCGAAC -> CCTGCCGAACG
CCCTGGACGCA -> CCTGGACGCAC
CCCTGGTTGCA -> CCTGGTTGCAA
CCCTGTGAGCG -> CCTGTGAGCGC
CCCTTATCTAG -> CCTTATCTAGG
CCCTTCGTTGT -> CCTTCGTTGTC
CCGAAACGCAA -> CGAAACGCAAT
CCGAACGGAGC -> CGAACGGAGCA
CCGAAGTCTGA -> CGAAGTCTGAG
CCGAATCTGCT -> CGAATCTGCTT
CCGACCGTTTA -> CGACCGTTTAT
CCGAGCGTGAA -> CGAGCGTGAAG
CCGAGGGTATA -> CGAGGGTATAG
CCGAGGTTGGA -> CGAGGTTGGAC
CCGAGTCCGCA -> CGAGTCCGCAA
CCGATGTTGCT -> CGATGTTGCTT
CCGATTGGTCC -> CGATTGGTCCT
CCGCAACCACT -> CGCAACCACTT
CCGCAAGGAGT -> CGCAAGGAGTA
CCGCACAACGC -> CGCACAACGCC
CCGCACAACTT -> CGCACAACTTG
CCGCATGGGGT -> CGCATGGGGTG
CCGCCAATATA -> CGCCAATATAG
CCGCGAAGACC -> CGCGAAGACCA
CCGCGCAGGAC -> CGCGCAGGACC
CCGCGGGCAAA -> CGCGGGCAAAA
CCGCGTATAAC -> CGCGTATAACA
CCGCTGTGATT -> CGCTGTGATTT
CCGGAAATTTA -> CGGAAATTTAC
CCGGCACAATA -> CGGCACAATAA
CCGGCTCAGAT -> CGGCTCAGATC
CCGGTAGGTGA -> CGGTAGGTGAA
CCGGTATTCAA -> CGGTATTCAAT
CCGGTCCGCAC -> CGGTCCGCACA
CCGGTTTGCAG -> CGGTTTGCAGT
CCGTGATGGTT -> CGTGATGGTTT
CCGTGCTGTGA -> CGTGCTGTGAT
CCGTGCTTACA -> CGTGCTTACAC
CCGTGGCAAAT -> CGTGGCAAATA
CCGTGGCATCC -> CGTGGCATCCG
CCGTGTACCCC -> CGTGTACCCCA
CCGTTCCAGCG -> CGTTCCAGCGC
CCGTTTATCAG -> CGTTTATCAGC
CCTAAAGCTTT -> CTAAAGCTTTG
CCTAAGAATTC -> CTAAGAATTCC
CCTAATAAGCA -> CTAATAAGCAC
CCTAATTGTGT -> CTAATTGTGTC
CCTACACTAAA -> CTACACTAAAC
CCTACTGTGCT -> CTACTGTGCTA
CCTAGAAGAAC -> CTAGAAGAACT
CCTATCTCGTT -> CTATCTCGTTT
CCTATTCCCAG -> CTATTCCCAGT
CCTCACCGAGG -> CTCACCGAGGT
CCTCAGCCGTG -> CTCAGCCGTGT
CCTCATCGTGC -> CTCATCGTGCG
CCTCCGAAGTC -> CTCCGAAGTCT
CCTCCGTGGCA -> CTCCGTGGCAA
CCTCTGAGATC -> CTCTGAGATCC
CCTCTGCCTGT -> CTCTGCCTGTC
CCTGAATAGAG -> CTGAATAGAGG
CCTGACCAACG -> CTGACCAACGG
CCTGACGCCGA -> CTGACGCCGAG
CCTGCCGAACG -> CTGCCGAACGG
CCTGGACGCAC -> CTGGACGCACC
CCTGGTTGCAA -> CTGGTTGCAAG
CCTGTCGTCCT -> CTGTCGTCCTA
CCTGTGAGCGC -> CTGTGAGCGCC
CCTGTGGAGGA -> CTGTGGAGGAG
CCTTATCTAGG -> CTTATCTAGGT
CCTTCCTCATC -> CTTCCTCATCG
CCTTCGTTGTC -> CTTCGTTGTCG
CCTTTCTAATA -> CTTTCTAATAC
CCTTTTGCCCC -> CTTTTGCCCCC
CGAAACAGACA -> GAAACAGACAC
CGAAACGCAAT -> GAAACGCAATC
CGAAACTCCAT -> GAAACTCCATG
CGAAATTGTTG -> GAAATTGTTGA
CGAACGGAGCA -> GAACGGAGCAG
CGAAGACCAGT -> GAAGACCAGTT
CGAAGCACTAG -> GAAGCACTAGT
CGAAGGCCGCG -> GAAGGCCGCGA
CGAAGTCTGAG -> GAAGTCTGAGA
CGAATCTGCTT -> GAATCTGCTTA
CGACCGTTTAT -> GACCGTTTATC
CGACGTCCTAC -> GACGTCCTACA
CGAGACGAGGT -> GAGACGAGGTG
CGAGCAGCGTA -> GAGCAGCGTAG
CGAGCCCTGGA -> GAGCCCTGGAC
CGAGCGTGAAG -> GAGCGTGAAGA
CGAGGGAAGCC -> GAGGGAAGCCA
CGAGGGTATAG -> GAGGGTATAGG
CGAGGTGATTG -> GAGGTGATTGT
CGAGGTTGGAC -> GAGGTTGGACC
CGAGTCCGCAA -> GAGTCCGCAAG
CGATAATGATG -> GATAATGATGG
CGATACGACGT -> GATACGACGTC
CGATATTATTA -> GATATTATTAA
CGATGAACCCA -> GATGAACCCAC
CGATGAGTCTG -> GATGAGTCTGT
CGATGGCCATC -> GATGGCCATCT
CGATGTTGCTT -> GATGTTGCTTG
CGATTGATGGC -> GATTGATGGCA
CGATTGGTCCT -> GATTGGTCCTA
CGCAACCACTT -> GCAACCACTTA
CGCAAGGAGTA -> GCAAGGAGTAG
CGCAATCGTAA -> GCAATCGTAAG
CGCAATCGTAT -> GCAATCGTATC
CGCACAACGCC -> GCACAACGCCG
CGCACAACTTG -> GCACAACTTGG
CGCACCTCTGC -> GCACCTCTGCC
CGCACGGCAGT -> GCACGGCAGTA
CGCAGGACCCT -> GCAGGACCCTA
CGCATCGGTCC -> GCATCGGTCCG
CGCATGGGGTG -> GCATGGGGTGC
CGCCAAGCTAC -> GCCAAGCTACC
CGCCAATATAG -> GCCAATATAGT
CGCCAGAGTCC -> GCCAGAGTCCG
CGCCATTACCC -> GCCATTACCCT
CGCCCTGGTTG -> GCCCTGGTTGC
CGCCGAGCGTG -> GCCGAGCGTGA
CGCCGGTAGGT -> GCCGGTAGGTG
CGCCGGTATTC -> GCCGGTATTCA
CGCCGTGCTTA -> GCCGTGCTTAC
CGCCTATTCCC -> GCCTATTCCCA
CGCCTCTGAGA -> GCCTCTGAGAT
CGCGAAGACCA -> GCGAAGACCAG
CGCGCAGGACC -> GCGCAGGACCC
CGCGCCATTAC -> GCGCCATTACC
CGCGCCTATTC -> GCGCCTATTCC
CGCGGGCAAAA -> GCGGGCAAAAG
CGCGTATAACA -> GCGTATAACAA
CGCGTCGTATC -> GCGTCGTATCC
CGCTCGATGAG -> GCTCGATGAGT
CGCTCTCAGGT -> GCTCTCAGGTC
CGCTCTCGCCG -> GCTCTCGCCGT
CGCTGCACACT -> GCTGCACACTT
CGCTGTGATTT -> GCTGTGATTTC
CGCTTTCCGCG -> GCTTTCCGCGG
CGGAAAGATGC -> GGAAAGATGCT
CGGAAATTTAC -> GGAAATTTACC
CGGAATAACCT -> GGAATAACCTT
CGGAGCAGATC -> GGAGCAGATCC
CGGAGGGCGTA -> GGAGGGCGTAT
CGGATCAGGAG -> GGATCAGGAGG
CGGATGTCACG -> GGATGTCACGA
CGGCAAAGGAA -> GGCAAAGGAAG
CGGCACAATAA -> GGCACAATAAG
CGGCAGTATCC -> GGCAGTATCCG
CGGCGCTTTCC -> GGCGCTTTCCG
CGGCTCAGATC -> GGCTCAGATCA
CGGCTCTGTGG -> GGCTCTGTGGT
CGGGACCAGAC -> GGGACCAGACG
CGGGATCGATT -> GGGATCGATTG
CGGGCAAAAGC -> GGGCAAAAGCC
CGGGCGTGGGA -> GGGCGTGGGAG
CGGGTCAATCT -> GGGTCAATCTT
CGGTACGTCCC -> GGTACGTCCCG
CGGTAGGTGAA -> GGTAGGTGAAC
CGGTATTCAAT -> GGTATTCAATT
CGGTATTTCTG -> GGTATTTCTGG
CGGTCAGTAAT -> GGTCAGTAATG
CGGTCCGAATC -> GGTCCGAATCT
CGGTCCGCACA -> GGTCCGCACAA
CGGTCCGCTGT -> GGTCCGCTGTG
CGGTGCTTACA -> GGTGCTTACAT
CGGTTCGTGGA -> GGTTCGTGGAA
CGGTTGTTCCG -> GGTTGTTCCGA
CGGTTTGCAGT -> GGTTTGCAGTC
CGTAAGGAGCG -> GTAAGGAGCGA
CGTAAGTCAAT -> GTAAGTCAATG
CGTACGAGGGA -> GTACGAGGGAA
CGTAGAACGGG -> GTAGAACGGGT
CGTAGACTTGC -> GTAGACTTGCG
CGTAGGCGGTC -> GTAGGCGGTCC
CGTATAACAAC -> GTATAACAACC
CGTATAGATAT -> GTATAGATATG
CGTATCCGTGG -> GTATCCGTGGC
CGTATCCTCAC -> GTATCCTCACC
CGTATCGGTAC -> GTATCGGTACG
CGTATTGCATG -> GTATTGCATGG
CGTCCCGCAAC -> GTCCCGCAACC
CGTCCTAATTG -> GTCCTAATTGT
CGTCCTACACT -> GTCCTACACTA
CGTCGAAACAG -> GTCGAAACAGA
CGTCGTATCCT -> GTCGTATCCTC
CGTGAACTCGA -> GTGAACTCGAT
CGTGAAGAGCG -> GTGAAGAGCGT
CGTGATACAGG -> GTGATACAGGC
CGTGATATGTT -> GTGATATGTTC
CGTGATGGTTT -> GTGATGGTTTT
CGTGCATGCTA -> GTGCATGCTAC
CGTGCGTACGA -> GTGCGTACGAG
CGTGCTGTGAT -> GTGCTGTGATA
CGTGCTTACAC -> GTGCTTACACG
CGTGGAATTCC -> GTGGAATTCCC
CGTGGCAAATA -> GTGGCAAATAG
CGTGGCATCCG -> GTGGCATCCGG
CGTGGCTCTTC -> GTGGCTCTTCT
CGTGGGAGACC -> GTGGGAGACCT
CGTGGGGATGG -> GTGGGGATGGC
CGTGGGTCCGA -> GTGGGTCCGAT
CGTGTACCCCA -> GTGTACCCCAC
CGTTATTGAGT -> GTTATTGAGTT
CGTTCCAGCGC -> GTTCCAGCGCC
CGTTCCCGTGC -> GTTCCCGTGCT
CGTTGTCGGAA -> GTTGTCGGAAA
CGTTTATCAGC -> GTTTATCAGCG
CGTTTTTTTGT -> GTTTTTTTGTA
CTAAACCTAAT -> TAAACCTAATA
CTAAAGCTTTG -> TAAAGCTTTGG
CTAAGAATTCC -> TAAGAATTCCT
CTAATAAGCAC -> TAATAAGCACT
CTAATACACAA -> TAATACACAAG
CTAATTGTGTC -> TAATTGTGTCG
CTACACTAAAC -> TACACTAAACC
CTACATCTCGA -> TACATCTCGAT
CTACCAGGTTC -> TACCAGGTTCA
CTACCCCAAGT -> TACCCCAAGTT
CTACCGGTTTG -> TACCGGTTTGC
CTACTGTGCTA -> TACTGTGCTAC
CTACTGTTGGC -> TACTGTTGGCC
CTAGAAGAACT -> TAGAAGAACTA
CTAGGAGGCGC -> TAGGAGGCGCC
CTAGGCATAAA -> TAGGCATAAAT
CTAGGTTGTTC -> TAGGTTGTTCC
CTAGTCCCCCG -> TAGTCCCCCGG
CTAGTCGCAAT -> TAGTCGCAATC
CTAGTGGTTGT -> TAGTGGTTGTT
CTAGTGTGAAT -> TAGTGTGAATT
CTATAAACTTC -> TATAAACTTCA
CTATCTCGTTT -> TATCTCGTTTT
CTATGAAAGTG -> TATGAAAGTGC
CTATTCCCAGT -> TATTCCCAGTC
CTCACCGAGGT -> TCACCGAGGTT
CTCAGATCACG -> TCAGATCACGC
CTCAGCCGTGT -> TCAGCCGTGTA
CTCAGGACCAG -> TCAGGACCAGC
CTCAGGTCTTC -> TCAGGTCTTCG
CTCATCGTGCG -> TCATCGTGCGT
CTCCATGGGGG -> TCCATGGGGGC
CTCCCCTTCGT -> TCCCCTTCGTT
CTCCGAAGTCT -> TCCGAAGTCTG
CTCCGTGGCAA -> TCCGTGGCAAA
CTCGATACGAC -> TCGATACGACG
CTCGATGAACC -> TCGATGAACCC
CTCGATGAGTC -> TCGATGAGTCT
CTCGCCGTGCT -> TCGCCGTGCTT
CTCGCTCTCAG -> TCGCTCTCAGG
CTCGTTTTTTT -> TCGTTTTTTTG
CTCTCAGGTCT -> TCTCAGGTCTT
CTCTCGCCGTG -> TCTCGCCGTGC
CTCTGAGATCC -> TCTGAGATCCA
CTCTGCCTGTC -> TCTGCCTGTCG
CTCTGTGGTTT -> TCTGTGGTTTA
CTCTTCGTTAT -> TCTTCGTTATT
CTCTTCTACAT -> TCTTCTACATC
CTCTTCTCTTT -> TCTTCTCTTTC
CTCTTTCGGTG -> TCTTTCGGTGC
CTGAATAGAGG -> TGAATAGAGGC
CTGACCAACGG -> TGACCAACGGA
CTGACCCATGT -> TGACCCATGTT
CTGACGCCGAG -> TGACGCCGAGC
CTGAGACGAAG -> TGAGACGAAGC
CTGAGATCCAA -> TGAGATCCAAA
CTGCACACTTA -> TGCACACTTAA
CTGCCGAACGG -> TGCCGAACGGA
CTGCCTGTCGT -> TGCCTGTCGTC
CTGCGGTTCGT -> TGCGGTTCGTG
CTGCTTAAACG -> TGCTTAAACGA
CTGGACGCACC -> TGGACGCACCT
CTGGAGTGATG -> TGGAGTGATGT
CTGGTTGCAAG -> TGGTTGCAAGT
CTGTCAGTTTA -> TGTCAGTTTAT
CTGTCGTCCTA -> TGTCGTCCTAA
CTGTGAGCGCC -> TGTGAGCGCCG
CTGTGATACTG -> TGTGATACTGA
CTGTGATTTCG -> TGTGATTTCGT
CTGTGCTACTG -> TGTGCTACTGT
CTGTGGACGTT -> TGTGGACGTTC
CTGTGGAGGAG -> TGTGGAGGAGC
CTGTGGTTTAC -> TGTGGTTTACA
CTGTTGGCCGG -> TGTTGGCCGGT
CTGTTTGAGAG -> TGTTTGAGAGA
CTTAAAAAGCC -> TTAAAAAGCCC
CTTAAACGAAG -> TTAAACGAAGG
CTTAACGTGGG -> TTAACGTGGGT
CTTAAGTATGC -> TTAAGTATGCT
CTTACACGTGA -> TTACACGTGAA
CTTACATACTC -> TTACATACTCC
CTTAGTCGATG -> TTAGTCGATGG
CTTATCTAGGT -> TTATCTAGGTT
CTTCACCGCAT -> TTCACCGCATG
CTTCACGCCCT -> TTCACGCCCTG
CTTCCCGACCG -> TTCCCGACCGT
CTTCCGTGATG -> TTCCGTGATGG
CTTCCTCATCG -> TTCCTCATCGT
CTTCGCATCGG -> TTCGCATCGGT
CTTCGTGATAT -> TTCGTGATATG
CTTCGTGGGGA -> TTCGTGGGGAT
CTTCGTTATTG -> TTCGTTATTGA
CTTCGTTGTCG -> TTCGTTGTCGG
CTTCTACATCT -> TTCTACATCTC
CTTCTCTTTCG -> TTCTCTTTCGG
CTTGAAATGCA -> TTGAAATGCAT
CTTGATTACGC -> TTGATTACGCT
CTTGCGCGCCT -> TTGCGCGCCTA
CTTGGAACGGG -> TTGGAACGGGC
CTTGGCGTAGA -> TTGGCGTAGAA
CTTGTGGTATC -> TTGTGGTATCG
CTTGTTCGTGC -> TTGTTCGTGCA
CTTTAGTCGGC -> TTTAGTCGGCA
CTTTATGGGAT -> TTTATGGGATA
CTTTCCGCGGG -> TTTCCGCGGGC
CTTTCGGTGCT -> TTTCGGTGCTT
CTTTCTAATAC -> TTTCTAATACA
CTTTGGCCCCG -> TTTGGCCCCGC
CTTTTGCCCCC -> TTTTGCCCCCA
GAAACAGACAC -> AAACAGACACA
GAAACGCAATC -> AAACGCAATCG
GAAACTCCATG -> AAACTCCATGG
GAAAGAACGTG -> AAAGAACGTGA
GAAAGATGCTA -> AAAGATGCTAC
GAAAGTGCATC -> AAAGTGCATCT
GAAATGCATGT -> AAATGCATGTC
GAAATTGTTGA -> AAATTGTTGAG
GAAATTTACCA -> AAATTTACCAT
GAACAATATAT -> AACAATATATC
GAACCATCACT -> AACCATCACTT
GAACCCACTTG -> AACCCACTTGT
GAACCGAGTCC -> AACCGAGTCCG
GAACGAGCCCT -> AACGAGCCCTG
GAACGCGCCAT -> AACGCGCCATT
GAACGGAGCAG -> AACGGAGCAGA
GAACGGGCGTG -> AACGGGCGTGG
GAACGGGTCAA -> AACGGGTCAAT
GAACGTGATAC -> AACGTGATACA
GAACTATAAAC -> AACTATAAACT
GAACTCGATGA -> AACTCGATGAA
GAAGAACCATC -> AAGAACCATCA
GAAGAACTATA -> AAGAACTATAA
GAAGACCAGTT -> AAGACCAGTTA
GAAGAGCGTAG -> AAGAGCGTAGA
GAAGCACTAGT -> AAGCACTAGTG
GAAGCCAAAGC -> AAGCCAAAGCT
GAAGGCCGCGA -> AAGGCCGCGAA
GAAGTCTGAGA -> AAGTCTGAGAC
GAAGTTCCGGA -> AAGTTCCGGAA
GAATAACCTTT -> AATAACCTTTC
GAATAGAGGCT -> AATAGAGGCTT
GAATCGGTTGT -> AATCGGTTGTT
GAATCTGCTTA -> AATCTGCTTAA
GAATTCCCATG -> AATTCCCATGG
GAATTCCTCCG -> AATTCCTCCGA
GAATTCTAGTC -> AATTCTAGTCG
GAATTTTGCGC -> AATTTTGCGCT
GACACAACACT -> ACACAACACTA
GACACCCCCAC -> ACACCCCCACC
GACCAACGGAT -> ACCAACGGATG
GACCAGACGGT -> ACCAGACGGTC
GACCAGCGAGC -> ACCAGCGAGCA
GACCAGTTAAA -> ACCAGTTAAAA
GACCCATGTTA -> ACCCATGTTAC
GACCCGCGCAG -> ACCCGCGCAGG
GACCCTACTGT -> ACCCTACTGTG
GACCGTTTATC -> ACCGTTTATCA
GACCTCAGCCG -> ACCTCAGCCGT
GACCTCCGTGG -> ACCTCCGTGGC
GACCTTTTGCC -> ACCTTTTGCCC
GACGAAACTCC -> ACGAAACTCCA
GACGAAGCACT -> ACGAAGCACTA
GACGAGGTGAT -> ACGAGGTGATT
GACGCACCTCT -> ACGCACCTCTG
GACGCCGAGCG -> ACGCCGAGCGT
GACGGAGGGCG -> ACGGAGGGCGT
GACGGTCAGTA -> ACGGTCAGTAA
GACGTCCTACA -> ACGTCCTACAC
GACGTTCCCGT -> ACGTTCCCGTG
GACTTGCGCGC -> ACTTGCGCGCC
GAGAATCGGTT -> AGAATCGGTTG
GAGACCTCCGT -> AGACCTCCGTG
GAGACGAAGCA -> AGACGAAGCAC
GAGACGAGGTG -> AGACGAGGTGA
GAGAGAATCGG -> AGAGAATCGGT
GAGATCCAAAA -> AGATCCAAAAC
GAGCACACAGG -> AGCACACAGGC
GAGCAGATCCT -> AGCAGATCCTG
GAGCAGCGTAG -> AGCAGCGTAGG
GAGCCCTGGAC -> AGCCCTGGACG
GAGCCTAAGAA -> AGCCTAAGAAT
GAGCGAGACGA -> AGCGAGACGAG
GAGCGCCGGTA -> AGCGCCGGTAG
GAGCGTAGACT -> AGCGTAGACTT
GAGCGTATCGG -> AGCGTATCGGT
GAGCGTGAAGA -> AGCGTGAAGAG
GAGGAGCACAC -> AGGAGCACACA
GAGGCGCCAGA -> AGGCGCCAGAG
GAGGCTTAACG -> AGGCTTAACGT
GAGGGAAGCCA -> AGGGAAGCCAA
GAGGGCGTATA -> AGGGCGTATAG
GAGGGTATAGG -> AGGGTATAGGG
GAGGTGATCAG -> AGGTGATCAGT
GAGGTGATTGT -> AGGTGATTGTG
GAGGTTGGACC -> AGGTTGGACCC
GAGTAGCGGCT -> AGTAGCGGCTC
GAGTCCGCAAG -> AGTCCGCAAGG
GAGTCCGCCAA -> AGTCCGCCAAT
GAGTCTGTGGA -> AGTCTGTGGAC
GAGTGATGTTC -> AGTGATGTTCA
GAGTGCACAAC -> AGTGCACAACA
GAGTTTTCTAG -> AGTTTTCTAGG
GATAATGATGG -> ATAATGATGGC
GATACAGGCAC -> ATACAGGCACC
GATACGACGTC -> ATACGACGTCC
GATACGCCAAG -> ATACGCCAAGC
GATACTGACCC -> ATACTGACCCA
GATAGAGTGCA -> ATAGAGTGCAC
GATATGATAGA -> ATATGATAGAG
GATATGTTCCA -> ATATGTTCCAG
GATATTATTAA -> ATATTATTAAG
GATCACGCACG -> ATCACGCACGG
GATCAGGAGGT -> ATCAGGAGGTG
GATCAGTGGGG -> ATCAGTGGGGG
GATCCAAAACA -> ATCCAAAACAC
GATCCTGTGGA -> ATCCTGTGGAG
GATCGATTGAT -> ATCGATTGATG
GATCTTCCGTG -> ATCTTCCGTGA
GATGAACCCAC -> ATGAACCCACT
GATGAGTCTGT -> ATGAGTCTGTG
GATGCTACCAG -> ATGCTACCAGG
GATGGCAATGG -> ATGGCAATGGG
GATGGCACACC -> ATGGCACACCA
GATGGCCATCT -> ATGGCCATCTG
GATGGCTACCC -> ATGGCTACCCC
GATGGTTTTCT -> ATGGTTTTCTC
GATGTCACGAA -> ATGTCACGAAA
GATGTTCACCA -> ATGTTCACCAC
GATGTTGCTTG -> ATGTTGCTTGA
GATTACGCTCG -> ATTACGCTCGA
GATTGATGGCA -> ATTGATGGCAA
GATTGGTCCTA -> ATTGGTCCTAG
GATTGTGTGTG -> ATTGTGTGTGG
GATTTCGTGGC -> ATTTCGTGGCT
GCAAAAATTTC -> CAAAAATTTCG
GCAAAAGCCCC -> CAAAAGCCCCT
GCAAAGGAAGT -> CAAAGGAAGTT
GCAAATAGATC -> CAAATAGATCT
GCAACCACTTA -> CAACCACTTAA
GCAAGGAGTAG -> CAAGGAGTAGC
GCAAGTAACTA -> CAAGTAACTAG
GCAATCGTAAG -> CAATCGTAAGG
GCAATCGTATC -> CAATCGTATCC
GCAATGGGAAT -> CAATGGGAATT
GCACAACACGG -> CACAACACGGA
GCACAACGCCG -> CACAACGCCGG
GCACAACTTGG -> CACAACTTGGC
GCACAATAAGG -> CACAATAAGGA
GCACACAGGCA -> CACACAGGCAC
GCACACCAGCT -> CACACCAGCTG
GCACACTTAAA -> CACACTTAAAA
GCACAGTTGAC -> CACAGTTGACG
GCACCACACGG -> CACCACACGGT
GCACCAGGTAA -> CACCAGGTAAT
GCACCTCTGCC -> CACCTCTGCCT
GCACGGCAGTA -> CACGGCAGTAT
GCACTAGTGGT -> CACTAGTGGTT
GCACTCGCTCT -> CACTCGCTCTC
GCAGATCCTGT -> CAGATCCTGTG
GCAGCGTAGGC -> CAGCGTAGGCG
GCAGGACCCTA -> CAGGACCCTAC
GCAGTATCCGA -> CAGTATCCGAG
GCAGTCAAACT -> CAGTCAAACTC
GCAGTCGGAAT -> CAGTCGGAATA
GCATAAATGCA -> CATAAATGCAT
GCATACTCTTC -> CATACTCTTCT
GCATCAAAAAG -> CATCAAAAAGA
GCATCCGGCTC -> CATCCGGCTCA
GCATCGGTCCG -> CATCGGTCCGA
GCATCTAGTGT -> CATCTAGTGTG
GCATGGCTTTA -> CATGGCTTTAT
GCATGGGGTGC -> CATGGGGTGCT
GCATGTCCCCT -> CATGTCCCCTA
GCCAAAGCTTC -> CCAAAGCTTCC
GCCAAGCTACC -> CCAAGCTACCG
GCCAATATAGT -> CCAATATAGTG
GCCAGAACGAG -> CCAGAACGAGC
GCCAGAGTCCG -> CCAGAGTCCGC
GCCATCTGCGG -> CCATCTGCGGT
GCCATTACCCT -> CCATTACCCTG
GCCCAATTATT -> CCCAATTATTT
GCCCCCATAGC -> CCCCCATAGCG
GCCCCGCACAA -> CCCCGCACAAC
GCCCCTGACGC -> CCCCTGACGCC
GCCCCTTATCT -> CCCCTTATCTA
GCCCTGGACGC -> CCCTGGACGCA
GCCCTGGTTGC -> CCCTGGTTGCA
GCCGAACGGAG -> CCGAACGGAGC
GCCGAGCGTGA -> CCGAGCGTGAA
GCCGCGAAGAC -> CCGCGAAGACC
GCCGCGTATAA -> CCGCGTATAAC
GCCGGTAGGTG -> CCGGTAGGTGA
GCCGGTATTCA -> CCGGTATTCAA
GCCGGTCCGCA -> CCGGTCCGCAC
GCCGTGCTTAC -> CCGTGCTTACA
GCCGTGTACCC -> CCGTGTACCCC
GCCGTTCCAGC -> CCGTTCCAGCG
GCCTAAGAATT -> CCTAAGAATTC
GCCTATTCCCA -> CCTATTCCCAG
GCCTCTGAGAT -> CCTCTGAGATC
GCCTGACCAAC -> CCTGACCAACG
GCCTGTCGTCC -> CCTGTCGTCCT
GCCTTCCTCAT -> CCTTCCTCATC
GCGAAGACCAG -> CGAAGACCAGT
GCGAGACGAGG -> CGAGACGAGGT
GCGAGCAGCGT -> CGAGCAGCGTA
GCGATAATGAT -> CGATAATGATG
GCGCAGGACCC -> CGCAGGACCCT
GCGCCAGAGTC -> CGCCAGAGTCC
GCGCCATTACC -> CGCCATTACCC
GCGCCGGTAGG -> CGCCGGTAGGT
GCGCCTATTCC -> CGCCTATTCCC
GCGCCTCTGAG -> CGCCTCTGAGA
GCGCGCCTATT -> CGCGCCTATTC
GCGCTGCACAC -> CGCTGCACACT
GCGCTTTCCGC -> CGCTTTCCGCG
GCGGCGCTTTC -> CGGCGCTTTCC
GCGGCTCTGTG -> CGGCTCTGTGG
GCGGGCAAAAG -> CGGGCAAAAGC
GCGGTCCGCTG -> CGGTCCGCTGT
GCGGTTCGTGG -> CGGTTCGTGGA
GCGTACGAGGG -> CGTACGAGGGA
GCGTAGAACGG -> CGTAGAACGGG
GCGTAGACTTG -> CGTAGACTTGC
GCGTAGGCGGT -> CGTAGGCGGTC
GCGTATAACAA -> CGTATAACAAC
GCGTATAGATA -> CGTATAGATAT
GCGTATCGGTA -> CGTATCGGTAC
GCGTATTGCAT -> CGTATTGCATG
GCGTCGTATCC -> CGTCGTATCCT
GCGTGAAGAGC -> CGTGAAGAGCG
GCGTGGGAGAC -> CGTGGGAGACC
GCTACCAGGTT -> CTACCAGGTTC
GCTACCCCAAG -> CTACCCCAAGT
GCTACCGGTTT -> CTACCGGTTTG
GCTACTGTTGG -> CTACTGTTGGC
GCTCAGATCAC -> CTCAGATCACG
GCTCGATGAGT -> CTCGATGAGTC
GCTCTCAGGTC -> CTCTCAGGTCT
GCTCTCGCCGT -> CTCTCGCCGTG
GCTCTGTGGTT -> CTCTGTGGTTT
GCTCTTCTACA -> CTCTTCTACAT
GCTGCACACTT -> CTGCACACTTA
GCTGTGATACT -> CTGTGATACTG
GCTGTGATTTC -> CTGTGATTTCG
GCTGTTTGAGA -> CTGTTTGAGAG
GCTTAAACGAA -> CTTAAACGAAG
GCTTAACGTGG -> CTTAACGTGGG
GCTTACACGTG -> CTTACACGTGA
GCTTACATACT -> CTTACATACTC
GCTTCCCGACC -> CTTCCCGACCG
GCTTCGTGATA -> CTTCGTGATAT
GCTTCGTGGGG -> CTTCGTGGGGA
GCTTGAAATGC -> CTTGAAATGCA
GCTTGATTACG -> CTTGATTACGC
GCTTGTGGTAT -> CTTGTGGTATC
GCTTTATGGGA -> CTTTATGGGAT
GCTTTCCGCGG -> CTTTCCGCGGG
GCTTTGGCCCC -> CTTTGGCCCCG
GGAAAGATGCT -> GAAAGATGCTA
GGAAATTTACC -> GAAATTTACCA
GGAACGCGCCA -> GAACGCGCCAT
GGAACGGGCGT -> GAACGGGCGTG
GGAAGAACCAT -> GAAGAACCATC
GGAAGCCAAAG -> GAAGCCAAAGC
GGAAGTTCCGG -> GAAGTTCCGGA
GGAATAACCTT -> GAATAACCTTT
GGAATTCCCAT -> GAATTCCCATG
GGAATTCTAGT -> GAATTCTAGTC
GGACCAGACGG -> GACCAGACGGT
GGACCAGCGAG -> GACCAGCGAGC
GGACCCGCGCA -> GACCCGCGCAG
GGACCCTACTG -> GACCCTACTGT
GGACCTTTTGC -> GACCTTTTGCC
GGACGCACCTC -> GACGCACCTCT
GGACGTTCCCG -> GACGTTCCCGT
GGAGACCTCCG -> GAGACCTCCGT
GGAGCACACAG -> GAGCACACAGG
GGAGCAGATCC -> GAGCAGATCCT
GGAGCGAGACG -> GAGCGAGACGA
GGAGGAGCACA -> GAGGAGCACAC
GGAGGCGCCAG -> GAGGCGCCAGA
GGAGGGCGTAT -> GAGGGCGTATA
GGAGGTGATCA -> GAGGTGATCAG
GGAGTAGCGGC -> GAGTAGCGGCT
GGAGTGATGTT -> GAGTGATGTTC
GGATACGCCAA -> GATACGCCAAG
GGATCAGGAGG -> GATCAGGAGGT
GGATCGATTGA -> GATCGATTGAT
GGATGGCACAC -> GATGGCACACC
GGATGTCACGA -> GATGTCACGAA
GGCAAAAGCCC -> GCAAAAGCCCC
GGCAAAGGAAG -> GCAAAGGAAGT
GGCAAATAGAT -> GCAAATAGATC
GGCAATGGGAA -> GCAATGGGAAT
GGCACAATAAG -> GCACAATAAGG
GGCACACCAGC -> GCACACCAGCT
GGCACAGTTGA -> GCACAGTTGAC
GGCACCACACG -> GCACCACACGG
GGCACCAGGTA -> GCACCAGGTAA
GGCAGTATCCG -> GCAGTATCCGA
GGCATAAATGC -> GCATAAATGCA
GGCATACTCTT -> GCATACTCTTC
GGCATCCGGCT -> GCATCCGGCTC
GGCCATCTGCG -> GCCATCTGCGG
GGCCCCGCACA -> GCCCCGCACAA
GGCCGCGAAGA -> GCCGCGAAGAC
GGCCGCGTATA -> GCCGCGTATAA
GGCCGGTCCGC -> GCCGGTCCGCA
GGCCGTTCCAG -> GCCGTTCCAGC
GGCCTTCCTCA -> GCCTTCCTCAT
GGCGCCAGAGT -> GCGCCAGAGTC
GGCGCTTTCCG -> GCGCTTTCCGC
GGCGGTCCGCT -> GCGGTCCGCTG
GGCGTAGAACG -> GCGTAGAACGG
GGCGTATAGAT -> GCGTATAGATA
GGCGTGGGAGA -> GCGTGGGAGAC
GGCTACCCCAA -> GCTACCCCAAG
GGCTCAGATCA -> GCTCAGATCAC
GGCTCTGTGGT -> GCTCTGTGGTT
GGCTCTTCTAC -> GCTCTTCTACA
GGCTTAACGTG -> GCTTAACGTGG
GGCTTGTGGTA -> GCTTGTGGTAT
GGCTTTATGGG -> GCTTTATGGGA
GGGAACGCGCC -> GGAACGCGCCA
GGGAAGAACCA -> GGAAGAACCAT
GGGAAGCCAAA -> GGAAGCCAAAG
GGGAATTCTAG -> GGAATTCTAGT
GGGACCAGACG -> GGACCAGACGG
GGGAGACCTCC -> GGAGACCTCCG
GGGATACGCCA -> GGATACGCCAA
GGGATCGATTG -> GGATCGATTGA
GGGATGGCACA -> GGATGGCACAC
GGGCAAAAGCC -> GGCAAAAGCCC
GGGCACAGTTG -> GGCACAGTTGA
GGGCCGCGTAT -> GGCCGCGTATA
GGGCGTATAGA -> GGCGTATAGAT
GGGCGTGGGAG -> GGCGTGGGAGA
GGGGAACGCGC -> GGGAACGCGCC
GGGGATGGCAC -> GGGATGGCACA
GGGGCACAGTT -> GGGCACAGTTG
GGGGGAACGCG -> GGGGAACGCGC
GGGGGCACAGT -> GGGGCACAGTT
GGGGTAGCGAT -> GGGTAGCGATA
GGGGTGCTTCG -> GGGTGCTTCGT
GGGTAGCGATA -> GGTAGCGATAA
GGGTATAGGGC -> GGTATAGGGCC
GGGTCAATCTT -> GGTCAATCTTC
GGGTCCGATGT -> GGTCCGATGTT
GGGTGCTTCGT -> GGTGCTTCGTG
GGTAATATAGC -> GTAATATAGCC
GGTACGTCCCG -> GTACGTCCCGC
GGTAGCGATAA -> GTAGCGATAAT
GGTAGGCATAC -> GTAGGCATACT
GGTAGGTGAAC -> GTAGGTGAACA
GGTATAGGGCC -> GTATAGGGCCG
GGTATCGATAT -> GTATCGATATT
GGTATTCAATT -> GTATTCAATTC
GGTATTTCTGG -> GTATTTCTGGA
GGTCAATCTTC -> GTCAATCTTCA
GGTCAGTAATG -> GTCAGTAATGC
GGTCCGAATCT -> GTCCGAATCTG
GGTCCGATGTT -> GTCCGATGTTG
GGTCCGCACAA -> GTCCGCACAAC
GGTCCGCTGTG -> GTCCGCTGTGA
GGTCCTAGAAG -> GTCCTAGAAGA
GGTCTTCGCAT -> GTCTTCGCATC
GGTGAACAATA -> GTGAACAATAT
GGTGATCAGTG -> GTGATCAGTGG
GGTGATTGTGT -> GTGATTGTGTG
GGTGCTTACAT -> GTGCTTACATA
GGTGCTTCGTG -> GTGCTTCGTGA
GGTTCACTTAG -> GTTCACTTAGT
GGTTCGTGGAA -> GTTCGTGGAAT
GGTTGCAAGTA -> GTTGCAAGTAA
GGTTGGACCCG -> GTTGGACCCGC
GGTTGTTCCGA -> GTTGTTCCGAT,GTTGTTCCGAA
GGTTGTTGCCC -> GTTGTTGCCCA
GGTTTACAGGC -> GTTTACAGGCC
GGTTTGCAGTC -> GTTTGCAGTCA
GGTTTTCTCTT -> GTTTTCTCTTC
GTAAAACTAGT -> TAAAACTAGTC
GTAACTAGGCA -> TAACTAGGCAT
GTAAGGAGCGA -> TAAGGAGCGAG
GTAAGTCAATG -> TAAGTCAATGA
GTAATATAGCC -> TAATATAGCCT
GTAATGCTTCG -> TAATGCTTCGT
GTACCCCACAC -> TACCCCACACG
GTACGAGGGAA -> TACGAGGGAAG
GTACGTCCCGC -> TACGTCCCGCA
GTAGAACGGGT -> TAGAACGGGTC
GTAGACTTGCG -> TAGACTTGCGC
GTAGCAAAAAT -> TAGCAAAAATT
GTAGCGATAAT -> TAGCGATAATG
GTAGCGGCTCT -> TAGCGGCTCTG
GTAGGCATACT -> TAGGCATACTC
GTAGGCGGTCC -> TAGGCGGTCCG
GTAGGTGAACA -> TAGGTGAACAA
GTATAACAACC -> TATAACAACCT
GTATAGATATG -> TATAGATATGA
GTATAGGGCCG -> TATAGGGCCGC
GTATCCGAGGG -> TATCCGAGGGT
GTATCCGTGGC -> TATCCGTGGCA
GTATCCTCACC -> TATCCTCACCG
GTATCGATATT -> TATCGATATTA
GTATCGGTACG -> TATCGGTACGT
GTATGCTTGAA -> TATGCTTGAAA
GTATTCAATTC -> TATTCAATTCT
GTATTGCATGG -> TATTGCATGGC
GTATTTCTGGA -> TATTTCTGGAG
GTCAAACTCAG -> TCAAACTCAGG
GTCAATCTTCA -> TCAATCTTCAC
GTCAATGACAC -> TCAATGACACC
GTCACGAAATT -> TCACGAAATTG
GTCACGTAAGT -> TCACGTAAGTC
GTCAGTAATGC -> TCAGTAATGCT
GTCAGTTTATT -> TCAGTTTATTC
GTCCCCCGGCA -> TCCCCCGGCAC
GTCCCCTATCT -> TCCCCTATCTC
GTCCCGCAACC -> TCCCGCAACCA
GTCCGAATCTG -> TCCGAATCTGC
GTCCGATGTTG -> TCCGATGTTGC
GTCCGCAAGGA -> TCCGCAAGGAG
GTCCGCACAAC -> TCCGCACAACT
GTCCGCCAATA -> TCCGCCAATAT
GTCCGCTGTGA -> TCCGCTGTGAT
GTCCTAATTGT -> TCCTAATTGTG
GTCCTACACTA -> TCCTACACTAA
GTCCTAGAAGA -> TCCTAGAAGAA
GTCGAAACAGA -> TCGAAACAGAC
GTCGATGGCCA -> TCGATGGCCAT
GTCGCAATCGT -> TCGCAATCGTA
GTCGGAAAGAT -> TCGGAAAGATG
GTCGGAATAAC -> TCGGAATAACC
GTCGGCAAAGG -> TCGGCAAAGGA
GTCGGGACCAG -> TCGGGACCAGA
GTCGTATCCTC -> TCGTATCCTCA
GTCGTCCTAAT -> TCGTCCTAATT
GTCTGAGACGA -> TCTGAGACGAA
GTCTGTGGACG -> TCTGTGGACGT
GTCTTCGCATC -> TCTTCGCATCG
GTGAACAATAT -> TGAACAATATA
GTGAACTCGAT -> TGAACTCGATG
GTGAAGAGCGT -> TGAAGAGCGTA
GTGAATTTTGC -> TGAATTTTGCG
GTGACGAAACT -> TGACGAAACTC
GTGAGCGCCGG -> TGAGCGCCGGT
GTGATACAGGC -> TGATACAGGCA
GTGATACTGAC -> TGATACTGACC
GTGATATGTTC -> TGATATGTTCC
GTGATCAGTGG -> TGATCAGTGGG
GTGATGGTTTT -> TGATGGTTTTC
GTGATGTTCAC -> TGATGTTCACC
GTGATTGTGTG -> TGATTGTGTGT
GTGATTTCGTG -> TGATTTCGTGG
GTGCACAACAC -> TGCACAACACG
GTGCATCTAGT -> TGCATCTAGTG
GTGCATGCTAC -> TGCATGCTACA
GTGCGTACGAG -> TGCGTACGAGG
GTGCTACTGTT -> TGCTACTGTTG
GTGCTGTGATA -> TGCTGTGATAC
GTGCTTACACG -> TGCTTACACGT
GTGCTTACATA -> TGCTTACATAC
GTGCTTCGTGA -> TGCTTCGTGAT
GTGGAATTCCC -> TGGAATTCCCA
GTGGACGTTCC -> TGGACGTTCCC
GTGGAGGAGCA -> TGGAGGAGCAC
GTGGCAAATAG -> TGGCAAATAGA
GTGGCATCCGG -> TGGCATCCGGC
GTGGCCTTCCT -> TGGCCTTCCTC
GTGGCTCTTCT -> TGGCTCTTCTA
GTGGGAGACCT -> TGGGAGACCTC
GTGGGGATGGC -> TGGGGATGGCA
GTGGGGGAACG -> TGGGGGAACGC
GTGGGTCCGAT -> TGGGTCCGATG
GTGGTATCGAT -> TGGTATCGATA
GTGGTTGTTGC -> TGGTTGTTGCC
GTGGTTTACAG -> TGGTTTACAGG
GTGTACCCCAC -> TGTACCCCACA
GTGTCGGGACC -> TGTCGGGACCA
GTGTGAATTTT -> TGTGAATTTTG
GTGTGGCCTTC -> TGTGGCCTTCC
GTGTGTGGCCT -> TGTGTGGCCTT
GTTAAAAGGCT -> TTAAAAGGCTT
GTTACGCTCTC -> TTACGCTCTCG
GTTATTGAGTT -> TTATTGAGTTT
GTTCACCACAG -> TTCACCACAGC
GTTCACTTAGT -> TTCACTTAGTC
GTTCCAGACCT -> TTCCAGACCTC
GTTCCAGCGCC -> TTCCAGCGCCT
GTTCCCCCTGC -> TTCCCCCTGCC
GTTCCCGTGCT -> TTCCCGTGCTG
GTTCCGAAACG -> TTCCGAAACGC
GTTCCGATTGG -> TTCCGATTGGT
GTTCCGGAAAT -> TTCCGGAAATT
GTTCGTGCATG -> TTCGTGCATGC
GTTCGTGGAAT -> TTCGTGGAATT
GTTGACGGAGG -> TTGACGGAGGG
GTTGAGCCTAA -> TTGAGCCTAAG
GTTGCAAGTAA -> TTGCAAGTAAC
GTTGCCCAATT -> TTGCCCAATTA
GTTGCTTGATT -> TTGCTTGATTA
GTTGGACCCGC -> TTGGACCCGCG
GTTGGCCGGTC -> TTGGCCGGTCC
GTTGTCGGAAA -> TTGTCGGAAAG
GTTGTTCCGAA -> TTGTTCCGAAA
GTTGTTCCGAT -> TTGTTCCGATT
GTTGTTGCCCA -> TTGTTGCCCAA
GTTTACAGGCC -> TTTACAGGCCG
GTTTATCAGCG -> TTTATCAGCGT
GTTTATTCCCT -> TTTATTCCCTG
GTTTGAGAGAA -> TTTGAGAGAAT
GTTTGCAGTCA -> TTTGCAGTCAA
GTTTTCTAGGA -> TTTTCTAGGAG
GTTTTCTCTTC -> TTTTCTCTTCG
GTTTTTTTGTA -> TTTTTTTGTAA
TAAAAAGCCCC -> AAAAAGCCCCT
TAAAACTAGTC -> AAAACTAGTCC
TAAAAGGCTTG -> AAAAGGCTTGT
TAAACCTAATA -> AAACCTAATAA
TAAACGAAGGC -> AAACGAAGGCC
TAAACTTCACC -> AAACTTCACCG
TAAAGCTTTGG -> AAAGCTTTGGC
TAAATGCATCA -> AAATGCATCAA
TAACAACCTAA -> AACAACCTAAA
TAACCTTTCTA -> AACCTTTCTAA
TAACGTGGGTC -> AACGTGGGTCC
TAACTAGGCAT -> AACTAGGCATA
TAAGAATTCCT -> AAGAATTCCTC
TAAGCACTCGC -> AAGCACTCGCT
TAAGGACCTTT -> AAGGACCTTTT
TAAGGAGCGAG -> AAGGAGCGAGA
TAAGTAGCAAA -> AAGTAGCAAAA
TAAGTATGCTT -> AAGTATGCTTG
TAAGTCAATGA -> AAGTCAATGAC
TAATAAGCACT -> AATAAGCACTC
TAATACACAAG -> AATACACAAGC
TAATATAGCCT -> AATATAGCCTG
TAATGATGGCT -> AATGATGGCTA
TAATGCTTCGT -> AATGCTTCGTG
TAATTGTGTCG -> AATTGTGTCGG
TACACAAGCCA -> ACACAAGCCAG
TACACGTGAAC -> ACACGTGAACT
TACACTAAACC -> ACACTAAACCT
TACAGGCACCA -> ACAGGCACCAC
TACAGGCCGTT -> ACAGGCCGTTC
TACATACTCCC -> ACATACTCCCC
TACATCTCGAT -> ACATCTCGATA
TACCAGGTTCA -> ACCAGGTTCAC
TACCATCAAGG -> ACCATCAAGGT
TACCCCAAGTT -> ACCCCAAGTTC
TACCCCACACG -> ACCCCACACGC
TACCCTGAATA -> ACCCTGAATAG
TACCGGTTTGC -> ACCGGTTTGCA
TACGACGTCCT -> ACGACGTCCTA
TACGAGGGAAG -> ACGAGGGAAGC
TACGCCAAGCT -> ACGCCAAGCTA
TACGCTCGATG -> ACGCTCGATGA
TACGCTCTCGC -> ACGCTCTCGCC
TACGTCCCGCA -> ACGTCCCGCAA
TACTCCCCTTC -> ACTCCCCTTCG
TACTCTTCTCT -> ACTCTTCTCTT
TACTGACCCAT -> ACTGACCCATG
TACTGTGCTAC -> ACTGTGCTACT
TACTGTTGGCC -> ACTGTTGGCCG
TACTTGGAACG -> ACTTGGAACGG
TAGAACGGGTC -> AGAACGGGTCA
TAGAAGAACTA -> AGAAGAACTAT
TAGACTTGCGC -> AGACTTGCGCG
TAGAGGCTTAA -> AGAGGCTTAAC
TAGAGTGCACA -> AGAGTGCACAA
TAGATATGATA -> AGATATGATAG
TAGATCTTCCG -> AGATCTTCCGT
TAGCAAAAATT -> AGCAAAAATTT
TAGCCTGACCA -> AGCCTGACCAA
TAGCGATAATG -> AGCGATAATGA
TAGCGGCGCTT -> AGCGGCGCTTT
TAGCGGCTCTG -> AGCGGCTCTGT
TAGGAGGCGCC -> AGGAGGCGCCA
TAGGCATAAAT -> AGGCATAAATG
TAGGCATACTC -> AGGCATACTCT
TAGGCGGTCCG -> AGGCGGTCCGC
TAGGGCCGCGT -> AGGGCCGCGTA
TAGGTGAACAA -> AGGTGAACAAT
TAGGTTGTTCC -> AGGTTGTTCCG
TAGTCCCCCGG -> AGTCCCCCGGC
TAGTCGATGGC -> AGTCGATGGCC
TAGTCGCAATC -> AGTCGCAATCG
TAGTCGGCAAA -> AGTCGGCAAAG
TAGTGACGAAA -> AGTGACGAAAC
TAGTGGTTGTT -> AGTGGTTGTTG
TAGTGTGAATT -> AGTGTGAATTT
TATAAACTTCA -> ATAAACTTCAC
TATAACAACCT -> ATAACAACCTA
TATAGATATGA -> ATAGATATGAT
TATAGCCTGAC -> ATAGCCTGACC
TATAGGGCCGC -> ATAGGGCCGCG
TATAGTGACGA -> ATAGTGACGAA
TATATCAGAAC -> ATATCAGAACC
TATCAGAACCG -> ATCAGAACCGA
TATCAGCGTAT -> ATCAGCGTATT
TATCCGAGGGT -> ATCCGAGGGTA
TATCCGTGGCA -> ATCCGTGGCAT
TATCCTCACCG -> ATCCTCACCGA
TATCGATATTA -> ATCGATATTAT
TATCGGTACGT -> ATCGGTACGTC
TATCTAGGTTG -> ATCTAGGTTGT
TATCTCGTTTT -> ATCTCGTTTTT
TATGAAAGTGC -> ATGAAAGTGCA
TATGATAGAGT -> ATGATAGAGTG
TATGCTTGAAA -> ATGCTTGAAAT
TATGGGATACG -> ATGGGATACGC
TATGTTCCAGA -> ATGTTCCAGAC
TATTAAGTAGC -> ATTAAGTAGCA
TATTATTAAGT -> ATTATTAAGTA
TATTCAATTCT -> ATTCAATTCTG
TATTCCCAGTC -> ATTCCCAGTCA
TATTCCCTGTG -> ATTCCCTGTGA
TATTGAGTTTT -> ATTGAGTTTTC
TATTGCATGGC -> ATTGCATGGCT
TATTTACTTGG -> ATTTACTTGGA
TATTTCTGGAG -> ATTTCTGGAGT
TCAAAAAGAGC -> CAAAAAGAGCG
TCAAACTCAGG -> CAAACTCAGGA
TCAAGGTAGGC -> CAAGGTAGGCA
TCAATCTTCAC -> CAATCTTCACG
TCAATGACACC -> CAATGACACCC
TCAATTCTGTC -> CAATTCTGTCA
TCACCACAGCA -> CACCACAGCAG
TCACCGAGGTT -> CACCGAGGTTG
TCACCGCATGG -> CACCGCATGGG
TCACGAAATTG -> CACGAAATTGT
TCACGCACGGC -> CACGCACGGCA
TCACGCCCTGG -> CACGCCCTGGT
TCACGTAAGTC -> CACGTAAGTCA
TCACTTAGTCG -> CACTTAGTCGA
TCACTTTAGTC -> CACTTTAGTCG
TCAGAACCGAG -> CAGAACCGAGT
TCAGATCACGC -> CAGATCACGCA
TCAGCCGTGTA -> CAGCCGTGTAC
TCAGCGTATTG -> CAGCGTATTGC
TCAGGACCAGC -> CAGGACCAGCG
TCAGGAGGTGA -> CAGGAGGTGAT
TCAGGTCTTCG -> CAGGTCTTCGC
TCAGTAATGCT -> CAGTAATGCTT
TCAGTGGGGGA -> CAGTGGGGGAA
TCAGTTTATTC -> CAGTTTATTCC
TCATCGTGCGT -> CATCGTGCGTA
TCCAAAACACA -> CCAAAACACAA
TCCAGACCTCA -> CCAGACCTCAG
TCCAGCGCCTC -> CCAGCGCCTCT
TCCATGGGGGC -> CCATGGGGGCA
TCCCAGTCACG -> CCCAGTCACGT
TCCCATGGGGT -> CCCATGGGGTA
TCCCCCGGCAC -> CCCCCGGCACA
TCCCCCTGCCG -> CCCCCTGCCGA
TCCCCTATCTC -> CCCCTATCTCG
TCCCCTTCGTT -> CCCCTTCGTTG
TCCCGACCGTT -> CCCGACCGTTT
TCCCGCAACCA -> CCCGCAACCAC
TCCCGTGCTGT -> CCCGTGCTGTG
TCCCTGTGAGC -> CCCTGTGAGCG
TCCGAAACGCA -> CCGAAACGCAA
TCCGAAGTCTG -> CCGAAGTCTGA
TCCGAATCTGC -> CCGAATCTGCT
TCCGAGGGTAT -> CCGAGGGTATA
TCCGATGTTGC -> CCGATGTTGCT
TCCGATTGGTC -> CCGATTGGTCC
TCCGCAAGGAG -> CCGCAAGGAGT
TCCGCACAACT -> CCGCACAACTT
TCCGCCAATAT -> CCGCCAATATA
TCCGCGGGCAA -> CCGCGGGCAAA
TCCGCTGTGAT -> CCGCTGTGATT
TCCGGAAATTT -> CCGGAAATTTA
TCCGGCTCAGA -> CCGGCTCAGAT
TCCGTGATGGT -> CCGTGATGGTT
TCCGTGGCAAA -> CCGTGGCAAAT
TCCGTGGCATC -> CCGTGGCATCC
TCCTAATTGTG -> CCTAATTGTGT
TCCTACACTAA -> CCTACACTAAA
TCCTAGAAGAA -> CCTAGAAGAAC
TCCTCACCGAG -> CCTCACCGAGG
TCCTCATCGTG -> CCTCATCGTGC
TCCTCCGAAGT -> CCTCCGAAGTC
TCCTGTGGAGG -> CCTGTGGAGGA
TCGAAACAGAC -> CGAAACAGACA
TCGATACGACG -> CGATACGACGT
TCGATATTATT -> CGATATTATTA
TCGATGAACCC -> CGATGAACCCA
TCGATGAGTCT -> CGATGAGTCTG
TCGATGGCCAT -> CGATGGCCATC
TCGATTGATGG -> CGATTGATGGC
TCGCAATCGTA -> CGCAATCGTAA
TCGCATCGGTC -> CGCATCGGTCC
TCGCCGTGCTT -> CGCCGTGCTTA
TCGCTCTCAGG -> CGCTCTCAGGT
TCGGAAAGATG -> CGGAAAGATGC
TCGGAATAACC -> CGGAATAACCT
TCGGCAAAGGA -> CGGCAAAGGAA
TCGGGACCAGA -> CGGGACCAGAC
TCGGTACGTCC -> CGGTACGTCCC
TCGGTCCGAAT -> CGGTCCGAATC
TCGGTGCTTAC -> CGGTGCTTACA
TCGGTTGTTCC -> CGGTTGTTCCG
TCGTAAGGAGC -> CGTAAGGAGCG
TCGTATCCGTG -> CGTATCCGTGG
TCGTATCCTCA -> CGTATCCTCAC
TCGTCCTAATT -> CGTCCTAATTG
TCGTCGAAACA -> CGTCGAAACAG
TCGTGATATGT -> CGTGATATGTT
TCGTGCATGCT -> CGTGCATGCTA
TCGTGCGTACG -> CGTGCGTACGA
TCGTGGAATTC -> CGTGGAATTCC
TCGTGGCTCTT -> CGTGGCTCTTC
TCGTGGGGATG -> CGTGGGGATGG
TCGTTATTGAG -> CGTTATTGAGT
TCGTTGTCGGA -> CGTTGTCGGAA
TCGTTTTTTTG -> CGTTTTTTTGT
TCTAATACACA -> CTAATACACAA
TCTACATCTCG -> CTACATCTCGA
TCTAGGAGGCG -> CTAGGAGGCGC
TCTAGGTTGTT -> CTAGGTTGTTC
TCTAGTCGCAA -> CTAGTCGCAAT
TCTAGTGTGAA -> CTAGTGTGAAT
TCTCAGGTCTT -> CTCAGGTCTTC
TCTCGATACGA -> CTCGATACGAC
TCTCGCCGTGC -> CTCGCCGTGCT
TCTCGTTTTTT -> CTCGTTTTTTT
TCTCTTCGTTA -> CTCTTCGTTAT
TCTCTTTCGGT -> CTCTTTCGGTG
TCTGAGACGAA -> CTGAGACGAAG
TCTGAGATCCA -> CTGAGATCCAA
TCTGCCTGTCG -> CTGCCTGTCGT
TCTGCGGTTCG -> CTGCGGTTCGT
TCTGCTTAAAC -> CTGCTTAAACG
TCTGGAGTGAT -> CTGGAGTGATG
TCTGTCAGTTT -> CTGTCAGTTTA
TCTGTGGACGT -> CTGTGGACGTT
TCTGTGGTTTA -> CTGTGGTTTAC
TCTTCACGCCC -> CTTCACGCCCT
TCTTCCGTGAT -> CTTCCGTGATG
TCTTCGCATCG -> CTTCGCATCGG
TCTTCGTTATT -> CTTCGTTATTG
TCTTCTACATC -> CTTCTACATCT
TCTTCTCTTTC -> CTTCTCTTTCG
TCTTTCGGTGC -> CTTTCGGTGCT
TGAAAGAACGT -> GAAAGAACGTG
TGAAAGTGCAT -> GAAAGTGCATC
TGAAATGCATG -> GAAATGCATGT
TGAACAATATA -> GAACAATATAT
TGAACCCACTT -> GAACCCACTTG
TGAACTCGATG -> GAACTCGATGA
TGAAGAGCGTA -> GAAGAGCGTAG
TGAATAGAGGC -> GAATAGAGGCT
TGAATTTTGCG -> GAATTTTGCGC
TGACACCCCCA -> GACACCCCCAC
TGACCAACGGA -> GACCAACGGAT
TGACCCATGTT -> GACCCATGTTA
TGACGAAACTC -> GACGAAACTCC
TGACGCCGAGC -> GACGCCGAGCG
TGACGGAGGGC -> GACGGAGGGCG
TGAGACGAAGC -> GAGACGAAGCA
TGAGAGAATCG -> GAGAGAATCGG
TGAGATCCAAA -> GAGATCCAAAA
TGAGCCTAAGA -> GAGCCTAAGAA
TGAGCGCCGGT -> GAGCGCCGGTA
TGAGTCTGTGG -> GAGTCTGTGGA
TGAGTTTTCTA -> GAGTTTTCTAG
TGATACAGGCA -> GATACAGGCAC
TGATACTGACC -> GATACTGACCC
TGATAGAGTGC -> GATAGAGTGCA
TGATATGTTCC -> GATATGTTCCA
TGATCAGTGGG -> GATCAGTGGGG
TGATGGCAATG -> GATGGCAATGG
TGATGGCTACC -> GATGGCTACCC
TGATGGTTTTC -> GATGGTTTTCT
TGATGTTCACC -> GATGTTCACCA
TGATTACGCTC -> GATTACGCTCG
TGATTGTGTGT -> GATTGTGTGTG
TGATTTCGTGG -> GATTTCGTGGC
TGCAAGTAACT -> GCAAGTAACTA
TGCACAACACG -> GCACAACACGG
TGCACACTTAA -> GCACACTTAAA
TGCAGTCAAAC -> GCAGTCAAACT
TGCATCAAAAA -> GCATCAAAAAG
TGCATCTAGTG -> GCATCTAGTGT
TGCATGCTACA -> GCATGCTACAC
TGCATGGCTTT -> GCATGGCTTTA
TGCATGTCCCC -> GCATGTCCCCT
TGCCCAATTAT -> GCCCAATTATT
TGCCCCCATAG -> GCCCCCATAGC
TGCCGAACGGA -> GCCGAACGGAG
TGCCTGTCGTC -> GCCTGTCGTCC
TGCGCGCCTAT -> GCGCGCCTATT
TGCGCTGCACA -> GCGCTGCACAC
TGCGGTTCGTG -> GCGGTTCGTGG
TGCGTACGAGG -> GCGTACGAGGG
TGCTACCAGGT -> GCTACCAGGTT
TGCTACTGTTG -> GCTACTGTTGG
TGCTGTGATAC -> GCTGTGATACT
TGCTTAAACGA -> GCTTAAACGAA
TGCTTACACGT -> GCTTACACGTG
TGCTTACATAC -> GCTTACATACT
TGCTTCGTGAT -> GCTTCGTGATA
TGCTTCGTGGG -> GCTTCGTGGGG
TGCTTGAAATG -> GCTTGAAATGC
TGCTTGATTAC -> GCTTGATTACG
TGGAACGGGCG -> GGAACGGGCGT
TGGAATTCCCA -> GGAATTCCCAT
TGGACCCGCGC -> GGACCCGCGCA
TGGACGCACCT -> GGACGCACCTC
TGGACGTTCCC -> GGACGTTCCCG
TGGAGGAGCAC -> GGAGGAGCACA
TGGAGTGATGT -> GGAGTGATGTT
TGGCAAATAGA -> GGCAAATAGAT
TGGCAATGGGA -> GGCAATGGGAA
TGGCACACCAG -> GGCACACCAGC
TGGCATCCGGC -> GGCATCCGGCT
TGGCCATCTGC -> GGCCATCTGCG
TGGCCCCGCAC -> GGCCCCGCACA
TGGCCGGTCCG -> GGCCGGTCCGC
TGGCCTTCCTC -> GGCCTTCCTCA
TGGCGTAGAAC -> GGCGTAGAACG
TGGCTACCCCA -> GGCTACCCCAA
TGGCTCTTCTA -> GGCTCTTCTAC
TGGCTTTATGG -> GGCTTTATGGG
TGGGAATTCTA -> GGGAATTCTAG
TGGGAGACCTC -> GGGAGACCTCC
TGGGATACGCC -> GGGATACGCCA
TGGGGATGGCA -> GGGGATGGCAC
TGGGGGAACGC -> GGGGGAACGCG
TGGGGGCACAG -> GGGGGCACAGT
TGGGGTAGCGA -> GGGGTAGCGAT
TGGGGTGCTTC -> GGGGTGCTTCG
TGGGTCCGATG -> GGGTCCGATGT
TGGTATCGATA -> GGTATCGATAT
TGGTCCTAGAA -> GGTCCTAGAAG
TGGTTGCAAGT -> GGTTGCAAGTA
TGGTTGTTGCC -> GGTTGTTGCCC
TGGTTTACAGG -> GGTTTACAGGC
TGGTTTTCTCT -> GGTTTTCTCTT
TGTAAAACTAG -> GTAAAACTAGT
TGTACCCCACA -> GTACCCCACAC
TGTCACGAAAT -> GTCACGAAATT
TGTCAGTTTAT -> GTCAGTTTATT
TGTCCCCTATC -> GTCCCCTATCT
TGTCGGAAAGA -> GTCGGAAAGAT
TGTCGGGACCA -> GTCGGGACCAG
TGTCGTCCTAA -> GTCGTCCTAAT
TGTGAATTTTG -> GTGAATTTTGC
TGTGAGCGCCG -> GTGAGCGCCGG
TGTGATACTGA -> GTGATACTGAC
TGTGATTTCGT -> GTGATTTCGTG
TGTGCTACTGT -> GTGCTACTGTT
TGTGGACGTTC -> GTGGACGTTCC
TGTGGAGGAGC -> GTGGAGGAGCA
TGTGGCCTTCC -> GTGGCCTTCCT
TGTGGTATCGA -> GTGGTATCGAT
TGTGGTTTACA -> GTGGTTTACAG
TGTGTCGGGAC -> GTGTCGGGACC
TGTGTGGCCTT -> GTGTGGCCTTC
TGTGTGTGGCC -> GTGTGTGGCCT
TGTTACGCTCT -> GTTACGCTCTC
TGTTCACCACA -> GTTCACCACAG
TGTTCCAGACC -> GTTCCAGACCT
TGTTCCGAAAC -> GTTCCGAAACG
TGTTCCGATTG -> GTTCCGATTGG
TGTTCGTGCAT -> GTTCGTGCATG
TGTTGAGCCTA -> GTTGAGCCTAA
TGTTGCCCAAT -> GTTGCCCAATT
TGTTGCTTGAT -> GTTGCTTGATT
TGTTGGCCGGT -> GTTGGCCGGTC
TGTTTGAGAGA -> GTTTGAGAGAA
TTAAAAAGCCC -> TAAAAAGCCCC
TTAAAAGGCTT -> TAAAAGGCTTG
TTAAACGAAGG -> TAAACGAAGGC
TTAACGTGGGT -> TAACGTGGGTC
TTAAGTAGCAA -> TAAGTAGCAAA
TTAAGTATGCT -> TAAGTATGCTT
TTACACGTGAA -> TACACGTGAAC
TTACAGGCCGT -> TACAGGCCGTT
TTACATACTCC -> TACATACTCCC
TTACCATCAAG -> TACCATCAAGG
TTACCCTGAAT -> TACCCTGAATA
TTACGCTCGAT -> TACGCTCGATG
TTACGCTCTCG -> TACGCTCTCGC
TTACTTGGAAC -> TACTTGGAACG
TTAGTCGATGG -> TAGTCGATGGC
TTAGTCGGCAA -> TAGTCGGCAAA
TTATCAGCGTA -> TATCAGCGTAT
TTATCTAGGTT -> TATCTAGGTTG
TTATGGGATAC -> TATGGGATACG
TTATTAAGTAG -> TATTAAGTAGC
TTATTCCCTGT -> TATTCCCTGTG
TTATTGAGTTT -> TATTGAGTTTT
TTATTTACTTG -> TATTTACTTGG
TTCAATTCTGT -> TCAATTCTGTC
TTCACCACAGC -> TCACCACAGCA
TTCACCGCATG -> TCACCGCATGG
TTCACGCCCTG -> TCACGCCCTGG
TTCACTTAGTC -> TCACTTAGTCG
TTCCAGACCTC -> TCCAGACCTCA
TTCCAGCGCCT -> TCCAGCGCCTC
TTCCCAGTCAC -> TCCCAGTCACG
TTCCCATGGGG -> TCCCATGGGGT
TTCCCCCTGCC -> TCCCCCTGCCG
TTCCCGACCGT -> TCCCGACCGTT
TTCCCGTGCTG -> TCCCGTGCTGT
TTCCCTGTGAG -> TCCCTGTGAGC
TTCCGAAACGC -> TCCGAAACGCA
TTCCGATTGGT -> TCCGATTGGTC
TTCCGCGGGCA -> TCCGCGGGCAA
TTCCGGAAATT -> TCCGGAAATTT
TTCCGTGATGG -> TCCGTGATGGT
TTCCTCATCGT -> TCCTCATCGTG
TTCCTCCGAAG -> TCCTCCGAAGT
TTCGCATCGGT -> TCGCATCGGTC
TTCGGTGCTTA -> TCGGTGCTTAC
TTCGTCGAAAC -> TCGTCGAAACA
TTCGTGATATG -> TCGTGATATGT
TTCGTGCATGC -> TCGTGCATGCT
TTCGTGGAATT -> TCGTGGAATTC
TTCGTGGCTCT -> TCGTGGCTCTT
TTCGTGGGGAT -> TCGTGGGGATG
TTCGTTATTGA -> TCGTTATTGAG
TTCGTTGTCGG -> TCGTTGTCGGA
TTCTAATACAC -> TCTAATACACA
TTCTACATCTC -> TCTACATCTCG
TTCTAGGAGGC -> TCTAGGAGGCG
TTCTAGTCGCA -> TCTAGTCGCAA
TTCTCTTCGTT -> TCTCTTCGTTA
TTCTCTTTCGG -> TCTCTTTCGGT
TTCTGGAGTGA -> TCTGGAGTGAT
TTCTGTCAGTT -> TCTGTCAGTTT
TTGAAATGCAT -> TGAAATGCATG
TTGACGGAGGG -> TGACGGAGGGC
TTGAGAGAATC -> TGAGAGAATCG
TTGAGCCTAAG -> TGAGCCTAAGA
TTGAGTTTTCT -> TGAGTTTTCTA
TTGATGGCAAT -> TGATGGCAATG
TTGATTACGCT -> TGATTACGCTC
TTGCAAGTAAC -> TGCAAGTAACT
TTGCAGTCAAA -> TGCAGTCAAAC
TTGCATGGCTT -> TGCATGGCTTT
TTGCCCAATTA -> TGCCCAATTAT
TTGCCCCCATA -> TGCCCCCATAG
TTGCGCGCCTA -> TGCGCGCCTAT
TTGCGCTGCAC -> TGCGCTGCACA
TTGCTTGATTA -> TGCTTGATTAC
TTGGAACGGGC -> TGGAACGGGCG
TTGGACCCGCG -> TGGACCCGCGC
TTGGCCCCGCA -> TGGCCCCGCAC
TTGGCCGGTCC -> TGGCCGGTCCG
TTGGCGTAGAA -> TGGCGTAGAAC
TTGGTCCTAGA -> TGGTCCTAGAA
TTGTAAAACTA -> TGTAAAACTAG
TTGTCGGAAAG -> TGTCGGAAAGA
TTGTGGTATCG -> TGTGGTATCGA
TTGTGTCGGGA -> TGTGTCGGGAC
TTGTGTGTGGC -> TGTGTGTGGCC
TTGTTCCGAAA -> TGTTCCGAAAC
TTGTTCCGATT -> TGTTCCGATTG
TTGTTCGTGCA -> TGTTCGTGCAT
TTGTTGAGCCT -> TGTTGAGCCTA
TTGTTGCCCAA -> TGTTGCCCAAT
TTTACAGGCCG -> TTACAGGCCGT
TTTACCATCAA -> TTACCATCAAG
TTTACTTGGAA -> TTACTTGGAAC
TTTAGTCGGCA -> TTAGTCGGCAA
TTTATCAGCGT -> TTATCAGCGTA
TTTATGGGATA -> TTATGGGATAC
TTTATTCCCTG -> TTATTCCCTGT
TTTCCGCGGGC -> TTCCGCGGGCA
TTTCGGTGCTT -> TTCGGTGCTTA
TTTCGTCGAAA -> TTCGTCGAAAC
TTTCGTGGCTC -> TTCGTGGCTCT
TTTCTAATACA -> TTCTAATACAC
TTTCTAGGAGG -> TTCTAGGAGGC
TTTCTCTTCGT -> TTCTCTTCGTT
TTTCTGGAGTG -> TTCTGGAGTGA
TTTGAGAGAAT -> TTGAGAGAATC
TTTGCAGTCAA -> TTGCAGTCAAA
TTTGCCCCCAT -> TTGCCCCCATA
TTTGCGCTGCA -> TTGCGCTGCAC
TTTGGCCCCGC -> TTGGCCCCGCA
TTTGTAAAACT -> TTGTAAAACTA
TTTTCTAGGAG -> TTTCTAGGAGG
TTTTCTCTTCG -> TTTCTCTTCGT
TTTTGCCCCCA -> TTTGCCCCCAT
TTTTGCGCTGC -> TTTGCGCTGCA
TTTTGTAAAAC -> TTTGTAAAACT
TTTTTGTAAAA -> TTTTGTAAAAC
TTTTTTGTAAA -> TTTTTGTAAAA
TTTTTTTGTAA -> TTTTTTGTAAA